Gustó niláng malaman kung alín sa mga gamit ko ang handâ kong ipamigáy.	They want to know which of my stuff I would be willing to part with.
Alín sa mga kautusáng itó ang nilabanan mo?	Which of these orders have you resisted?
Alín sa mga kotse mo ang mas madalás mong sinásakyán?	Which one among your cars do you more often use?
Alíng dokumento ang maglálamán ng mga pangalan ng mga kalahók?	Which document will contain the names of the participants?
Alíng kantá ni Elvis ang alám mong kantahín?	Which song of Elvis would you know how to sing?
Alín dito ang sayó?	Which of these is yours?
Alín bisikleta ang gustó mo?	Which bicycle would you like?
Alín ang mas magandá?	Which is prettier?
Pumilì ka kahit alín ang gustó mo.	Choose whatever you like.
Alín ang mas masaráp?	Which one is more delicious?
Alín sa dalawá ang gustó mo?	Which of the two would you like?
Alín ang mas mahirap tugtugín? Ang piano o ang violin?	Which is more difficult to play? The piano or the violin?
Hindî alám ni Neneng kung alíng simbahan ang sásalihan niyá.	Neneng didn't know which church she should go to.
Hindî ko alám kung alíng solusyón ang gagana.	I don't know which solution will work.
Alín ang gustó mong bilhín?	Which one do you want to buy?
Alin yung saakin?	Which is mine?
Alin ang kay Taro?	Which are Taro's?
Alin dito ang gitara mo?	Which is your guitar?
Aling sapatos ang napakaliit?	Which shoes are too small?
Aling bansa ang iyong pinanggagalingan?	Which country do you come from?
Aling planeta ang pinakamalapit sa Araw?	Which planet is nearest to the Sun?
Alin ang mas gusto mo, ang ulam, o ang isda?	Do you prefer meat or fish?
Nasa aling baitang ang iyong kapatid na babae?	What grade is your sister in?
Kung may Makina ng Oras ka, aling taon ka bibisita?	If you had a time machine, which year would you visit?
