Nakakakain ba silá ng tatlóng beses sa isáng araw?	Are they able to eat three times a day?
Iláng araw mayroón sa Hulyo?	How many days are there in July?
Kaya mo bang kitain ang US$500 sa isáng araw?	Can you earn US$500 in a day?
Umiikot ang mga planeta sa araw.	The planets are orbiting the sun.
Anóng oras lumubóg ang araw kahapon.	What time did the sun set yesterday?
Bawa't araw iníiwanan akó ng nanay ko ng baon.	Each day my mom would leave me allowance.
Saán bandá ang silang ng araw?	Where will the sun rise?
Magdédesisyón ang korte sa kaso ni Rhodora ngayóng araw.	The court will decide on Rhodora's case today.
Bukas ay araw ng Paskó!	Tomorrow is Christmas Day!
Huwág mong titigan ang araw.	Don't stare at the sun.
Malapit nang lumitáw ang araw.	The sun is about to appear.
Sisikat na mulî ang araw kasí tumigil na ang ulán.	The sun will shine again because the rain has already stopped.
Mabilís na nagdaán ang sampúng araw.	The past ten days have passed rapidly.
Taón-taóng idinadaos ang kumperénsiyá sa loób ng limáng araw.	Every year, the conference is held for five days.
Anóng oras sumikat ang araw kanina?	What time did the sun rise earlier / this morning?
Kay gandang araw!	What a lovely day!
Maganda ang araw.	It's a nice day.
Napabahay ako buong araw.	I stayed home all day.
Umulan buong araw kahapon.	It rained all day yesterday.
Maaga akong umuwi bawat araw.	I go home early every day.
Ang araw ay sumusunog na bola.	The sun is a flaming ball.
Talagang bisi siya buong araw.	He was very busy all day.
Matahimik na araw kami sa bukid.	We spent a quiet day in the country.
Di nagawa ang Roma sa isang araw.	Rome was not built in a day.
Naglaro siya ng tenis buong araw.	He played tennis all day long.
Wala akong nabenta sa araw na ito.	I had no sales today.
Anong paborito mong parte ng araw?	What's your favorite part of the day?
Wala ako sa bayan nang ilang araw.	I'll be out of town for a few days.
Sumisinag ang araw nang maliwanag.	The sun shone brightly.
Ayos ang bilyete para tatlong araw.	The ticket holds good for three days.
Huwag bumilad sa araw nang matagal.	Don't stay in the sun too long.
Makakalimutan mo rin ako balang araw.	You'll forget about me someday.
Tumigil siya sa otel nang ilang araw.	She stayed at the hotel for several days.
Pinagaling ng araw ang kanyang kulay.	The sunshine improved his color.
Buong araw nanatiling tahimik si Tom.	Tom kept silent all day long.
Tatlong araw na lamang bago ang Pasko.	It's only three days until Christmas.
Gumagawa ako ng tanghalian bawat araw.	I make lunch every day.
Tatlong araw na lamang bago ang Pasko.	It's only three days till Christmas.
Buong araw ay naglinis ako ng kuwarto.	I spent the whole day cleaning up the room.
Isang araw, lumuwas si Elisa ng Madrid.	One day, Elisa left for Madrid.
Mananatili ako sa bahay sa araw na ito.	I will stay home today.
Nabubuhay ng tatlong araw ang paruparo.	Butterflies live for three days.
Sa taglamig, ang mga araw ay mas maikli.	Days are shorter in winter.
Ang tumal ng negosyo sa mag araw na ito.	Business is so slow these days.
Aling planeta ang pinakamalapit sa Araw?	Which planet is nearest to the Sun?
Dalawampung sigarilyo siya sa isang araw.	He smokes twenty cigarettes a day.
Sisikat muli ang araw sa madaling panahon.	The sun will shine again soon.
Magandang araw. Ikaw ba si Sherlock Holmes?	Good day. Are you Mr. Sherlock Holmes?
Alaala ko talaga ang araw na pinanganak ka.	I remember the day you were born very well.
Mataas na ang araw nang umalis ako sa kama.	When I got out of bed, the sun was already high in the sky.
Kalilipat lamang nila rito noong isang araw.	They moved in just the other day.
Dumating ang sagot matapos ang tatlong araw.	The reply came after three days.
Iyon ang pinakamagaling na araw sa buhay ko.	That was the best day of my life.
Binili ko ang aklat na ito noong isang araw.	I bought this book the other day.
Nagkasakit siya noong nakalipas na mga araw.	He fell ill a few days ago.
Sa pagbalik ng taglamig, umiikli na ang araw.	With the coming of winter, days are getting shorter.
Kumakanta ang tandang tuwing pagsikat ng araw.	The rooster crows at sunrise.
Kung hindi dahil sa araw, hindi tayo mabubuhay.	If it were not for the sun, we could not live at all.
Pinapakain ko ang aking pusa sa araw at sa gabi.	I feed my cat every morning and every evening.
Sumisikat ang araw nang mas maaga kapag tag-araw,	The sun rises earlier in the summer.
Hulaan mo kung sino ang nakita ko sa araw na ito!	Guess who I met today!
Naramdaman niya ang init ng araw sa kanyang balat.	He felt the warmth of the sun on his skin.
Anong oras ka bumabangon sa mga araw na may pasok?	What time do you get up on schooldays?
Talagang malinaw ang umagang araw na di ko matingnan.	The morning sunshine is so bright that I can't look at it.
