Makíkilala mo ang buóng pamilya ko.	You will meet my whole family.
Nanlálabán siyá nang buóng lakás.	She fights/resists with all her might.
Isá sa pinakamalinis sa buóng bansâ ang barangáy namin.	Our neighborhood is one of the cleanest in the entire country.
Inawit namin nang buóng siglá ang pambansáng awit.	We sang the national anthem with absolute energy.
Nilakad namin ang buóng mall.	We walked the entire mall.
Nagdurusa ang buóng daigdíg dahil sa pandemyá ng Covid-19.	The whole world is suffering because of the Covid-19 pandemic.
Nakita ko ang buông pangyayari.	I saw the whole thing / incident.
Nag-aksayá tayo ng isáng buóng araw para sa witness na iyán.	We wasted a whole day for that witness.
Kakalat ang balità sa buóng bansâ.	The news will spread all over the country.
Hindî si Magallanes ang unang naglayág sa buóng mundó.	Magellan was not the first to sail the globe.
Ang dati kong kásintahan ang ginúgunitá ko buóng araw.	I'm thinking about my ex-girlfriend all day.
Kumakalat ang mga pantál sa kaniyáng buóng katawán.	The hives are spreading all over his body.
Magbábakasyón ang buóng pamilya sa Disyembre.	The whole family will go on a vacation in December.
Mahalín mo akó ng buóng pusò (mo).	Love me with all your heart.
Sa bukid ka makákariníg ng huni ng mga ibon buóng araw.	You will be able to hear the chirping of birds all day in the fields.
Nakíkinabang ang buóng pamilya niyá sa asawa niyá.	His whole family is benefiting from his wife.
Napabahay ako buong araw.	I stayed home all day.
Umulan buong araw kahapon.	It rained all day yesterday.
Bumiyahe siya sa buong mundo.	He traveled about the world.
Talagang bisi siya buong araw.	He was very busy all day.
Buong taong bukas ang tindahan.	The store is open all the year round.
Naglaro siya ng tenis buong araw.	He played tennis all day long.
Buong gabi kaming sumayaw nina Tom.	Tom and I danced all night long.
Namumula sa otonyo ang buong bundok.	The whole mountain turns red in autumn.
Natatakpan ng niyebe ang buong bansa.	The whole country was covered with snow.
Buong araw nanatiling tahimik si Tom.	Tom kept silent all day long.
Namumula sa tag-ulan ang buong bundok.	The whole mountain turns red in autumn.
Maganda ang panahon nang buong linggo.	The weather has been nice all week.
Nasira ang buong bayan dahil sa sunog.	The entire town was destroyed in a fire.
Buong araw ay naglinis ako ng kuwarto.	I spent the whole day cleaning up the room.
Naiintindihan ng buong daigdig ang wika ko.	The whole world understands my language.
Sabi ni Maria na magsasayaw siya buong gabi.	Mary said she was going to dance all night.
May higit sa pitong libong wika sa buong mundo.	There are more than seven thousand languages in the world.
Kinakain nila ang kalahati ng trigo ng buong mundo.	They eat half the world's wheat.
Ang Amerika ang pinaka-magandang lugar sa buong mundo.	America is the greatest country in the world.
May naniniwala na may parte sa utak at ito ay responsable para sa mga insulto at ito ay mas aktibo sa ibang tao. Ito ay sakit at kung minsan ay endemik sa buong rasa.	Some believe that there is a brain part that is responsible for insults and it is more active in some people. It is a sickness, sometimes endemic in an entire race.
