Humingî akó ng tulong kay John.	I asked John for help.
Humingî ng paumanhín si Lisa sa kaniyáng mga kaibigan.	Lisa apologized to her friends.
Tumakbó akó at humingî ng tulong.	I ran and asked for help.
Hindî ka maghihirap kung hihingî ka ng tulong.	You won't suffer if you ask for help.
Humingî ng tawad si Mary.	Mary asked for forgiveness.
Humingî ka ng pera sa nanay mo.	Ask for some money from your mom.
Humihingî ng limós ang pulubi kay James.	The beggar is asking James for alms.
Huwág kang hihingî ng tulong sa akin.	Don't ask for any help from me.
Hihingî ka ba ng pahintulot sa tatay ni Jane?	Would you be asking Jane's father for consent?
Humingî akó ng paumanhín dahil natagalán kamí.	I asked for forgiveness for taking so long.
Humihingî akó ng tawad tungkól sa kalat.	I'm sorry about the mess.
Kahit humingî siyá ng tawad, galít pa rin akó.	Even if he asked for forgiveness, I would still be mad.
Agád ay humingî ng tulong ang empleado.	The employee immediately asked for help.
Kabibigay ko lang sa iyó ng pera kahapon, ngayón humihingî ka na namán?	I just gave you money yesterday, now you're asking again?
Hindî pa ba lumalapit sa iyó si Bob para humingî ng tulong?	Hasn't Bob approached you yet to ask for help?
Nilapitan ni Jack si Peter para humingî ng tulong.	Jack approached Peter to ask for help.
Sásadyaín ko si Bob para humingî ng tulong sa kaniyá.	I will purposely go to see Bob to ask his help.
Humingi ka ng tawad.	You should apologize.
Humingi siya ng pagkain.	He asked for food.
Hindi mo kailangang humingi ng tawad.	You don't have to apologize.
Mabuti pang humingi ka ng payo sa doktor.	You had better ask the doctor for advice.
Kahit humingi siya ng tawad, galit pa rin ako.	Even if he asked for forgiveness, I would still be mad.
Dapat humingi tayo ng walis para walisan ang sahig.	We must ask for a broom to sweep the floor.
Dapat kang humingi ng tawad sa kanya, at ngayon din.	You must apologize to her, and do it at once.
