Ang batás ay dapat ipinápatupád.	The law should be enforced.
Anó ang naramdamán mo nang ipalabás itó?	What did you feel when it was shown?
Anóng kautusán ang ipinalabás ng reyna?	What order was issued by the queen?
Anong palabas sa 10?	What is on Channel 10?
Anong pinapalabas sa teatro?	What is playing at the theater?
Ayaw ipakilala ni Emma ang amá ng kaniyáng anák.	Emma don't want to introduce the father of her child.
Ayaw ko ng mga nakakatakot na palabas.	I don't like scary movies.
Ayokong malaman na ginágastá mo sa mga bisyo mo ang ipinápadalá kong pera.	I do not want to find out that you are spending on your vices the money I send you.
Bakit ayaw mong ipakita sa akin ang picture mo?	Why don't you want to show me your picture?
Bakit hindî mo akó ipakilala sa kaniyá?	Why won't you introduce me to her?
Binasa ko muli ang mga sulat mong pinadala sa akin.	I was rereading the letters you sent to me.
Bukas siguro akó makákabilí ng ipinabibilí mo.	I might be able to buy tomorrow what you asked me to buy for you.
Daan-daáng tiket ang ipinamigáy ng kapitán.	The captain gave away hundreds of tickets.
Dapat itóng ipamigáy ni Xander sa mga mahirap.	He should give it to the poor.
Dapat nang ipatupád ang pinirmahán niyáng kontrata.	The contract that she signed must now be enforced.
Gumagana ang programang ipinatútupád nilá.	The program their implementing is working.
Gumastos si Jack ng malakí para ipagawâ ang kotse niyá.	Jack spent a lot to have his car repaired.
Gustó kong ipahayág ang aking damdamin.	I want to express my feelings.
Gustó niláng malaman kung alín sa mga gamit ko ang handâ kong ipamigáy.	They want to know which of my stuff I would be willing to part with.
Handâ niyáng ipamigáy ang pagkain sa akin.	She was more than willing to give me food.
Hindî kailangang ipamigáy ni Haidee ang paborito niyáng laruán.	Haidee didn't have to give up her favorite toy.
Hindî ko pa naibíbigáy kay Bill yung ipinadalá mong regalo.	I have not given to Bill yet the gift you sent through me.
Hindî niyá ipinaalám sa asawa niyá na may sakít siyá.	She did not inform her husband that she's ill.
Hindî pa namin ipinápaalám kay Irene na nandito ka na.	We are not letting Irene know yet that you are already here.
Hiníhintáy kong ipalabás ang súsunód na pelíkulá ni James Bond.	I am waiting for the next James Bond movie to be shown.
Huwág kang súsunód kung sa palagáy mo ay malî ang ipinápagawâ sa iyó.	Don't comply if you feel that what you're being asked to do is wrong.
Huwág mong kalimutan ang ipinabibilí ko sa iyó.	Don't forget what I'm asking you to buy for me.
Inasikaso mo ba 'yung ipinagágawà ko sa iyó?	Did you attend to that thing I asked you to do?
Ipaalam mo sa akin kung saan ka mananatili.	Let me know where you're staying.
Ipadadala nang koreo ang sulat bukas.	The letter will be mailed tomorrow.
Ipahayág mo ang iyóng sarili.	Express yourself.
Ipakíkilala mo siyá bilang nobya mo.	You will introduce her as your girlfriend.
Ipakíkilala nilá ang bagong CEO bukas.	They will introduce the new CEO tomorrow.
Ipakilala mo akó sa kaibigan mo.	Introduce me to your friend.
Ipakilala mo ang panauhin sa mga batà.	Introduce the guest to the children.
Ipakilala mo sa kanilá ang palagì mong kasama.	Let them know the company you keep.
Ipakita mo muna ang ID mo bago kita papasukin.	Show me your ID first before I let you in.
Ipakita mo sa akin ang passport mo.	Show me your passport.
Ipakita mo sa akin kung paano gamitin itó.	Show me how to use this.
Ipakita mo sa akin.	Show me.
Ipakita niyo sa akin.	Show me.
Ipakita sa akin.	Show me.
Ipaliwanag mo ang iyong sarili.	Explain yourself.
Ipáliwanag mo itó sa amin kasí hindî namin siyá maintindihán.	Explain this to us because we can't understand it.
Ipamigáy mo na lang ang ibá mong mga laruán na malulumà lang kasí ayaw mo na sa kanilá.	Just give away some of your toys that will just get old because you don't like them anymore.
Ipápaalám ninyó sa akin kung áalís na kayó.	You should inform me if you're about to leave.
Ipápahayág ko ang mga plano sa pulong.	I will announce the plans in the meeting.
Ipápahayág ko ang pasasalamat ko kay Debra.	I will express my gratitude to Debra.
Ipápahayág ng bagong lider ang programa niyá.	The new leader will announce her programs.
Ipápahayág ni Sierra ang mga paborito niyáng kandidato.	Sierra will announce her favorite candidates.
Ipapakilala kita sa aking mga magulang.	I will introduce you to my parents.
Ipapakilala ko siyá sa iyó.	I will introduce her to you.
Ipápalabás ang patalastás sa Super Bowl.	The commercial will air during the Super Bowl.
Ipápalabás ni Joko ang maiklíng presentasyón bukas.	Joko will show the short presentation tomorrow.
Ipapaliwanag ko ang lahat mamaya.	I'll explain it all later.
Ipápaliwanag ko sa inyó ang nangyari.	I will explain to you what happened.
Ipápamigáy ko ang mga lumang gamit ko.	I will give away my old stuff.
Ipápatupád ang mga pagbabago ngayóng Agosto.	The changes will take effect this August.
Ipinaayós ang kotse.	The car has been fixed.
Ipinadalá niyá ang sinagután niyáng aplikasyón.	She sent her filled-out application.
Ipinahayág na ba nilá ang nanalo sa patímpalák?	Have they announced the winner of the contest?
Ipinahayág ng gurò ang misyón at bisyón ng páaralán.	The teacher stated the school's mission and vision.
Ipinahayág ng pangulo ang pagpápatupád ng batás militár.	The president declared the execution of martial law.
Ipinahayág ni Butch ang súsunód na CEO ng kompanyá.	Butch announced the next CEO of the company.
Ipinahayág ni Daniel ang pagkadismayá niyá.	Daniel expressed his dismay.
Ipinahayág ni Lyka ang pagmamahál niyá kay Mateo.	Lyka expressed her love for Mateo.
Ipinahayág nilá na akó ang magsasanay sa kanilá.	They announced that I would train them.
Ipinakíkilala niyá ang sarili bilang Camilla.	She introduces herself as Camilla.
Ipinakíkilala siyá sa ilalim ng ibáng mga pangalan.	He is identified under other names.
Ipinakilala kamí ni Lloyd sa tindera.	Lloyd introduced us to the saleswoman.
Ipinakilala ng tagapangulo ang bagong propesór.	The chairperson introduced the new professor.
Ipinakilala ni Michael si Jane kay Juan.	Michael introduced Jane to Juan.
Ipinakilala niya ako sa kanya sa parti.	She introduced me to him at the party.
Ipinakilala niyá akó sa lahát ng nakasalubong namin.	He introduced me to everyone we met on the way.
Ipinakita ko ang libró sa kaibigan ko.	I showed the book to my friend.
Ipinakita mo na ba sa tatay mo ang grades mo?	Have you already shown your grades to your father?
Ipinakita niyá ang mga letrang nasa dingdíng.	He showed the letters on the wall.
Ipinakita sa TV yung aksidente kaninang umaga.	The accident this morning was shown on TV.
Ipinalabás nilá itó nang waláng paalam.	They showed this without permission.
Ipinalabás niláng ikáw ang may kasalanan.	They made it appear that it was your fault.
Ipinalabás niyá sa akin ang ID ko.	He asked me to take out my ID.
Ipinalabás sa telebisyón ang kasál niná Anne at Erwan.	Anne and Erwan's Wedding was shown on television.
Ipinaliwanag ko ang proseso sa kanya.	I explained the process to him.
Ipinamigáy ba niyá itó sa inyó?	Did she pass it out to you?
Ipinamigáy ng organisasyón ang mga gamót sa mga bíktima ng bagyó.	The organization dispensed medicine to typhoon survivors.
Ipinamigáy ni Jonathan ang kaniyáng mga bulaklák.	Jonathan had given away his flowers.
Ipinamigáy ni Lola Ruth ang 70 porsiyento ng kaniyáng kayamanan.	Grannie Ruth gave away 70 percent of her fortune.
Ipinamigáy siyá noóng apat na taón siyá, hindî ba?	She was given away when she was four, right?
Ipinápaalám ko sa inyó na mag-áasawa na akó.	I'm letting you know that I am already getting married.
Ipinápahayág kong hindî akó kailanmán mag-áasawa.	I declare that I will never marry.
Ipinápahayág ng magsasaká ang kaniláng mga hinaíng.	The farmers are expressing their frustrations.
Ipinápahayág ng pámahalaán ang posisyón nilá sa isyu.	The government is announcing their position on the issue.
Ipinápahayág niyá ngayón ang súsunód na hakbáng.	She's announcing the next step right now.
Ipinápahayág sa radyo na suspendido ang mga klase.	The radio announces the suspension of classes.
Ipinápakita ba sa iyó ni Jane ang lamán ng bag niyá?	Does Jane show you the contents of her bag?
Ipinápalabás na ang teleserye ni Judy Ann.	Judy Ann's telenovela is being shown.
Ipinápalabás ni Dionne na sinungaling akó.	Dionne makes it appear that I'm a liar.
Ipinápamigáy nang libre ang mga halaman.	The plants are given away for free.
Ipinápamigáy ng matandáng babae ang mga lumang páhayagán.	The old woman is giving away old newspapers.
Ipinatupád ko sa kaniyá ang kaniyáng pangako.	I made him fulfull his promise.
Ipinatupád ng kompanyá ang bago niláng polisiya.	The company implemented their new policy.
Ipinatupád ng mga awtoridád ang pagbabawal sa paninigarilyo.	The authorities imposed a smoking ban.
Ipinatupád ng mga pinuno ang mga paghihigpit sa kaniláng organisasyón.	The leaders imposed restrictions in their organization.
Ipinatupád ng páaralán ang bagong kuríkulúm sa Filipino.	The school implemented the new Filipino curriculum.
Ipinatupád nilá ang mungkahi kong solusyón.	They acted upon upon my suggested solution.
Isáng taón nang ipinápatupád ang batás na nagbabawal sa catcalling.	The anti-catcalling law has been in force for one year.
Isiping mabuti kung papaano mo siyá ipakíkilala.	Give careful thought as to how you will introduce her.
Iyón ang araw na ipinakilala sa akin si Rey.	That was the day when Rey was introduced to me.
Kahapon ko pa ipinalabás sa iyó ang basura.	I told you to take out the trash yesterday yet.
Kailán ipápahayág ng gurò ang resulta ng pagsusulit?	When will the teacher announce the result?
Kailán mo ipápakita sa akin ang wedding pictures ninyó?	When will you show me your wedding pictures?
Kailangan mong ipahayág ang nanalo.	You need to declare the winner.
Kapag papayagan mo akong magsalita, maaari kong ipaliwanag ang lahat.	If you allow me to speak, I'll be able to explain everything.
Kumuha si Rosmon ng iláng libró para ipamigáy sa mga kaklase niyá.	Rosmon took several books to give to his classmates.
Lumipad ang isang bubuyog palabas ng bintana.	A bumblebee flew out the window.
Mabuti pang ipagawa mo iyan sa akin para sa iyo.	You'd better let me do that for you.
Magkano ang ginastos mo para ipagawâ ang kotse mo?	How much did you spend to have your car repaired?
Mahirap ipahayág ang mga bagay na hindî mo maunawaan.	It's difficult to express things that you don't understand.
Mahirap mangyari ang posibilidád na ipápamigáy ko ang kuwintás ko.	The likelihood that I will give up my necklace is rather slim.
Makiníg tayo sa ipínapaliwanag ng titser.	Let's listen to what the teacher is explaining.
Malapit nang ipalabás ang pagtatanghál ni Vice.	Vice's performance will be shown soon.
Mas pipiliin ko ang pamamasyal kaysa sa panonood ng palabas.	I prefer going for a walk to seeing the movie.
Masayá akó kapág ipinápamigáy ko ang mga bagay na hindî ko na kailangan.	I'm happy when I gave away the stuff that I no longer need.
Matátanggáp mo ang ipinadalá ko sa Martés.	You will receive what I sent you on Tuesday.
May bagong pátakarán na gustó niláng ipatupád simulâ sa isáng linggó.	There's a new policy that they'd like to implement beginning next week.
May gustó kamíng ipaalám sa iyó.	There's something we'd like you to know.
Nagagastos kayâ ni Daniel ang ipinadaláng pera ng kaniyáng amá?	Is Daniel spending his father's remittance?
Nag-alalá si Nanay na baka ipinamigáy mo lang iyón.	Mom was worried you had just given it away.
Nagdasál silá bago ipalabás ang kaniláng pelíkulá.	They prayed before showing their movie.
Nag-iba ang aming paraan sa buhay nang ipinakilala ang sibilisasyong taga-Europa.	Our mode of life has changed since the introduction of European civilization.
Nag-iba ang ating paraan sa buhay nang ipinakilala ang sibilisasyong taga-Europa.	Our mode of life has changed since the introduction of European civilization.
Nagsisikap siláng ipatupád ang modernong paggamót.	They are trying to implement modern health treatment.
Nagulat akó na ipápamigáy ni Dawn ang kaniyáng koleksiyón.	I was stunned Dawn was giving her collection away.
Nahirapan akóng maghanáp nitóng ipinabibilí mo.	I had a tough time looking for this thing that your asked me to buy for you.
Nakabilí ka ba ng ipinabibilí ko sa iyó?	Were you able to buy what I asked you to buy for me?
Nakuha mo ba ang perang ipinadalá ko (sa iyó)?	Did you get the money I sent you?
Nalúlungkót ba si Spike na ipinamigáy niyá ang kaniyáng reló?	Is Spike sad that he gave his watch away?
Namilì kamí ng mga lumang damít na pwede na nating ipamigáy.	We chose from our old clothes those that we may already give away.
Nasunód mo ba ang ipinápagawâ ko sa iyó?	Were you able to follow through what I asked you to do?
Natuwâ akó nang ipayahág mo ang desisyón mo.	I was happy when you announced your decision.
Natuwâ siyá nang ipalabás ang video.	She was happy when the video was shown.
Oo, puwedeng ipamigáy sa akin ni Lara ang mga sapatos niyá.	Yes, Lara could give me her shoes.
Paano mo ipápakita na nirerespeto mo siyá?	How can you show that you respect him?
Paúlit-ulit niyáng ipinakíkilala ang nobyo.	He repeatedly introduces his boyfriend.
Pinagawa niya sa amin ang trabaho.	He made us do the work.
Pinakilala niya ako sa kanyang kapatid na lalaki.	She introduced me to her brother.
Pinakita niya sa akin ang kanyang album.	She showed me her album.
Pinál ang hatol at dapat na itóng ipatupád.	The decision is final and enforceable.
Pinalabas niya ang isang pirasong tsok.	He took out a piece of chalk.
Sa tingin ko ang dahilan kung bakit napakagaling ni Tom sa Pranses ay dahil nanonood siya ng maraming palabas sa wikang Pranses.	I think the reason Tom is so good at French is that he watches a lot of French movies.
Si Tom ang bida sa palabas.	Tom was the star of the show.
Sinimulán niláng ipamigáy ang mga regalo.	They started handing out the gifts.
Sundan mo ako at ipakikita ko sa iyo ang daan.	Follow me and I will show you the way.
Walâ akóng kailangang ipáliwanag.	I have nothing to explain.
Wala akong oras na ipaliwanag ito nang detalye.	I have no time to explain this in detail.
