Ipakilala mo akó sa kaibigan mo.	Introduce me to your friend.
Ipinakilala niyá akó sa lahát ng nakasalubong namin.	He introduced me to everyone we met on the way.
Ipapakilala ko siyá sa iyó.	I will introduce her to you.
Ipinakilala ni Michael si Jane kay Juan.	Michael introduced Jane to Juan.
Ipakilala mo ang panauhin sa mga batà.	Introduce the guest to the children.
Ipakilala mo sa kanilá ang palagì mong kasama.	Let them know the company you keep.
Bakit hindî mo akó ipakilala sa kaniyá?	Why won't you introduce me to her?
Ayaw ipakilala ni Emma ang amá ng kaniyáng anák.	Emma don't want to introduce the father of her child.
Iyón ang araw na ipinakilala sa akin si Rey.	That was the day when Rey was introduced to me.
Ipinakilala kamí ni Lloyd sa tindera.	Lloyd introduced us to the saleswoman.
Ipinakilala ng tagapangulo ang bagong propesór.	The chairperson introduced the new professor.
Ipinakíkilala siyá sa ilalim ng ibáng mga pangalan.	He is identified under other names.
Ipinakíkilala niyá ang sarili bilang Camilla.	She introduces herself as Camilla.
Paúlit-ulit niyáng ipinakíkilala ang nobyo.	He repeatedly introduces his boyfriend.
Ipakíkilala nilá ang bagong CEO bukas.	They will introduce the new CEO tomorrow.
Ipakíkilala mo siyá bilang nobya mo.	You will introduce her as your girlfriend.
Isiping mabuti kung papaano mo siyá ipakíkilala.	Give careful thought as to how you will introduce her.
Ipinakilala niya ako sa kanya sa parti.	She introduced me to him at the party.
Ipapakilala kita sa aking mga magulang.	I will introduce you to my parents.
Pinakilala niya ako sa kanyang kapatid na lalaki.	She introduced me to her brother.
Nag-iba ang ating paraan sa buhay nang ipinakilala ang sibilisasyong taga-Europa.	Our mode of life has changed since the introduction of European civilization.
Nag-iba ang aming paraan sa buhay nang ipinakilala ang sibilisasyong taga-Europa.	Our mode of life has changed since the introduction of European civilization.
