Natutukoy ko kung anó ang malî sa sagót mo.	I can tell what's wrong in your answer.
Hindî malíng mangarap nang gising.	Daydreaming is not wrong.
Bakit malíng magyabáng kung mas mayaman ka kaysa sa ibáng tao?	Why is it wrong to brag if you are richer than another person?
Sa palagáy ko ay malî.	I think there's a mistake.
Pipilitin niyáng pagawaín ka ng bagay na malî.	He will force you to do something that is not right.
Malî ang nasakyán niyáng trén!	She was on the wrong train!
Pinuná ko ang malíng pamamalakad ng kompanyá.	I criticized the company's poor policies.
Malî ba akó?	Am I not right?
Malî ang tao kong minahál.	I loved the wrong person.
Itatakdâ nilá sa pulong ang mga pamantayan ng tamà at malî.	They will set the standards of right and wrong in the meeting.
Mali.	Wrong.
Alam mong mali iyon.	You knew it was wrong.
Inaasahan kong mali ka.	I wish you were wrong.
Pakiramdam kong may mali.	I feel that something is wrong.
Klaro na mali ang lalaki.	It is evident that the man is wrong.
Maraming mali itong databeys.	This database contains many errors.
Walang mali sa iyong sanaysay.	There are no mistakes in your essay.
May mali sa calculator na ito.	Something is wrong with this calculator.
Gumawa ng maraming mali si Tom.	Tom made many mistakes.
Siguro mali ang daang tinahak natin.	We must've taken the wrong road.
Di ko isip sa isang saglit na mali ka.	I do not for a moment think you are wrong.
Inaasahan kong mali ka, pero alam kong tama ka.	I wish you were wrong, but I know that you're right.
Halu-halong katotohanan at mali ang bawat opinyon.	Every opinion is a mixture of truth and mistakes.
Di siya makasalita ng Pranses nang walang konting mali.	He cannot speak French without making a few mistakes.
Di makaisang tugtog si Tomas sa kanyang ukelele nang walang mali.	Tom can't even play one song on his ukulele without making mistakes.
