ibigáy : i- [verb] to give something; to grant something; * focus on the object being given
bigyán : -an [verb] to give something to someone; * focus on the receiver of the given item
bumigáy : -um- [verb] to get broken or damaged; to finally give in; to be homosexual or come out of the closet (figurative)
magbigayan : mag-an [verb] to compromise; to give one another; to allow one another
mapagbigáy : [adjective] generous; bountiful
magbigáy : ma- [verb] to give; to give out; to grant; to equip; to donate; to allow
bigáy : [noun] gift; present; something given
maibigáy : mai- [verb] to be able to give something
ipamigáy : ipang- [verb] to give away something; to distribute something; to pass around something; to dispense something
pagbibigáy : [noun] giving; act of consideration; donation
mamigáy : mang- [verb] to give out; to distribute; to dispense
mabigyán : ma-an [verb] to be given; to be granted
makapagbigáy : makapag- [verb] to be able to give
bigayan : [noun] giving (one another); mutual tolerance; exchanging of gifts; distribution
magbigay-daán : mag- [verb] to give a way to do; to give an opportunity; to give way (let pass);
pagkamapagbigáy : pagkamapag- [adjective] generosity
pakibigyán : paki- please give
pamimigáy : [noun] distributing; distribution; giving; giving out
kabíbigáy : kaRO- [verb] to have just given

pahirám : [noun] please lend; something lent to someone
hiramín : -in [verb] to borrow something
humirám : -um- [verb] to borrow
hirám : [adjective] borrowed; adapted
hiramán : -an [verb] to borrow something from someone
ipahirám : ipa- [verb] to lend; to let someone borrow something
ihirám : i- [verb] to borrow something on someone's behalf

dalhín : -in [verb] to bring something; to carry something; to deliver something
magdalá : mag- [verb] to bring; to carry; to deliver; to convey; to take to
dala-dalá : [adjective/noun] bringing; being brought with one; something carried around
ipadalá : ipa- [verb] to send something; to deliver something; to pass something on
padalá : [noun] sent thing(s); consignment; the thing consigned; thing passed on/to
dalâ : [adjective] carried; brought
magpadalá : magpa- [verb] to send; to transmit; to carry away; to be swayed
dalá : [noun] load; something carried along; cargo; something brought along; burden; [adjective] carried; brought
dalhán : -an [verb] to bring something to someone; * focus on the person being brought something
madalá : ma- [verb] to be able to bring something; to happen to bring something; to be able to tag along
padalhán : pa-an [verb] to send something (to someone)
dalaín : -in [verb] to make someone experience something unpleasant
dalahin : [noun] load
págdadalá : [noun] bringing; delivering; delivery
pagpápadalá : [noun] the act of sending something
makapagdalá : makapag- [verb] to be able to bring
maipadalá : maipa- [verb] to be able to send something; to be able to deliver something; to be able to pass something on


pumasok : -um- [verb] to go in; to enter; to get in; to go to school or work; to be hired as
ipasok : i- [verb] to put something in; to take something/someone in; * focus on the item/person being put/placed/taken in
pasukan : -an [verb] to enter something into; to go to work; to go to school
pasok : [noun] entry; entrance; admission; trespass; school day; work day
papasók : [adjective] incoming; entering; coming in to; [adverb] inwards
pagpasok : [noun] entry; admission; infiltration; going to work; going to school; upon entering
pasukin : -in [verb] to enter something; to go into something
makapasok : maka- [verb] to be able to enter
pasukán : [noun] start of the school year; the school year; entrance; entryway; entry
magpasok : mag- [verb] to bring in; to take in; to introduce; to interpose; to put in; to insert; to enroll
mapasok : ma- [verb] to be able to enter; to be entered
papasukin : pa-in [verb] to allow someone to enter
mamasukan : mang-an [verb] to have a job; to be employed as
pamasok : [noun] clothes one uses when going to school, office, factory, etc.
maglabas-pasok : mag- [verb] to go in and out; to enter and exit
kakapasok : kaka- just entered; just went to school/work
maipasok : mai- [verb] to be able to enter; to be able to put it
pagkákapasok : [noun] entry
lumabas-pasok : -um- [verb] to go in and out
mapasukan : ma-an [verb] to enter somewhere; to go to work/school somewhere
pakipasok : paki- please enter; please pull in

buksán : -an [verb] to open something; to turn something on (a light); * focus on the thing being opened or turned on
bukás : [adjective] open; on
magbukás : mag- [verb] to open
bumukás : -um- [verb] to open; to be open
mabuksán : ma-an [verb] to be able to open something; to open something;
ibukás : i- [verb] to open something
pagbubukás : [noun] opening
pagbuksán : pag-an [verb] to open to let someone in/enter
nakabukás : naka- [adjective] open; on
pambukás : pang- [noun] can opener; a tool to open something
pakibukás : paki- please open; please turn on

isará : i- [verb] to close something; to shut something; to shut off something
pagpapasará : pagCV- [noun] closure; closing something
magsará : mag- [verb] to close; to shut; to shut off; to bring to an end
sarhán : -an [verb] to close something
panará : [noun] anything used for fastening (for a door, window, etc.)
nakasará : naka- [adjective] closed
sumará : -um- [verb] to become closed
ipasará : ipa- [verb] to have something closed
pagkasará : magka- [noun] shutting; closing; upon shutting; upon closing
pagsasará : pagCV- [noun] closing; the act of closing
maisará : mai- [verb] to be able to close something; to be able to shut something; to be able to shut off something.

patáy : [adjective] dead; deceased; [expressions] crap / oh my gosh / dang (slang)
patayín : -in [verb] to kill someone; to slaughter something (an animal); to turn off something; to shut off something; to extinguish something
pumatáy : -um- [verb] to kill; to extinguish
pagpatáy : pag- [noun] murder; killing
patayan : -an [noun] slaughter; killing
patáy-patayan : [noun] playing dead; pretending to be dead
mapatáy : ma- [verb] to be able to kill something (OF); to be able to turn off / extinguish (OF); to be killed (AF)
pamatáy : [noun] anything used for killing or turning off or extinguishing; [adjective] stunning clothes (colloquial); killer (smile)
magkámatayan : magka-an [verb] to fight to the death
magpatáy : mag- [verb] to slaughter (animals); to kill
nakapatáy : naka- [adjective] dead; turned off
patayan ng hayop : [noun] slaughterhouse
ipapatáy : ipa- [verb] to have someone killed
pagkakapatáy : pagkaka- [noun] killing; death
makapatáy : maka- [verb] to be able to kill
patáy-dampót : [adjective] unconscious; dead weight

mamatáy : ma- [verb] to die
kamatayan : [noun] death; doom
nakamámatáy : [adjective] deadly; fatal
magpakamatáy : magpaka- [verb] to commit suicide
katayán : [noun] slaughterhouse
mámamátay-tao : [noun] killer; murderer; assassin
pagkamatáy : [noun] death
ikamatáy : ika- [verb] to cause death
parusang kamatayan : [noun] death penalty
pagpápakamatáy : [noun] suicide
mamatayán : ma-an [verb] to suffer the loss of someone (due to death)

barilín : -in [verb] to shoot something; to gun something down
pagbabarilín : pagCV-in [verb] to shoot up something/somewhere; to shoot down something
baríl : [noun] gun; firearm
mabaríl : ma- [verb] to be shot; to shoot unintentionally
pamamaríl : [noun] shooting; gunning; hunting
bumaríl : -um- [verb] to shoot; to gun down
mamaríl : mang- [verb] to hunt; to shoot
barilan : [noun] shooting; shooting incident
pagbaríl : [noun] shooting
makipagbarilán : makipag-an [verb] to get in a shoot out; to exchange gunfire
tagabaríl : [noun] shooter

kunin : -in [verb] to get something; to take something; to obtain something; to fetch something; to hire someone
kumuha : -um- [verb] to get; to obtain; to take; to take up; to fetch
Kuha mo? : [phrase] Understood? Do you get it?
makuha : ma- [verb] to get something; to obtain something; to be able to get something; to be able to obtain something; to cope successfully with something; to manage something
kunan : -an [verb] to get something from someone; to take from someone; to get some of something; to take a picture of something
pagkuha : [noun] obtaining; taking; getting; securing
makakuha : maka- [verb] to be able to get; to be able to obtain; to be able to take
manguha : mang- [verb] to gather; to pick (ex., fruit); to take; to gather many/several things
ikuha : i- [verb] to get something for someone; to fetch for someone
kuha : [noun] getting; obtaining
makunan : ma-an [verb] to capture; to miscarry
ipakuhà : ipa- [verb] to have someone get something
pangkuha : something for getting/obtaining
kakakuha : kaka- just got; just obtained

magtanóng : mag- [verb] to ask a question; to question; to ask; to enquire
tanungín : -in [verb] to ask about something; to ask someone; to ask something; to question someone; to interrogate someone;
itanóng : i- [verb] to ask something; to inquire about something
tanóng : [noun] question
patanóng : [adjective] interrogative; uncertain;[adverb] questioningly
pagtatanóng : [noun] questioning; interrogation
matanóng : [adjective] inquisitive
matanóng : ma- [verb] to ask someone (LF); to be asked (AF)
pananóng : [grammar] interrogative; [noun] question mark; [adjective] interrogative
magtanung-tanóng : mag- [verb] to ask around; to inquire
maitanóng : mai- [verb] to be able to ask something
makapagtanóng : makapag- [verb] to be able to ask
katanungan : [noun] question
tagapagtanóng : [noun] interrogator

tulóy : [interjection] come in! [adverb] as a result; as a consequence; might as well; push through; proceed; continue; next; eventually; accordingly
matulóy : ma- [verb] to follow through; to go on; to continue; to push through
magpatuloy : magpa- [verb] to continue; to proceed; to accommodate
patuloy : [adjective] continuous; constant; perpetual; [adverb] continue; continues; continuously; keeping on; keep on
ipagpatuloy : ipag- [verb] to go ahead with something; to keep on with something; to continue with something; to pursue something
tulúy-tulóy : [adjective/adverb] is endless; non-stop; continuously.; continuous; never stops; keeps on; keeps on happening
tumulóy : -um- [verb] to continue; to go ahead; to come in; to go on; to proceed; to board; to reside temporarily
itulóy : i- [verb] to continue something; to keep on doing something
tuluyan : -an [noun] temporary home or shelter; [adverb] eventually; in the end; consequently
tuluyán : -an [verb] to goad someone on; to continue on to somewhere
ituluyan : i-an [verb] to complete or finalize something (colloquial); to harm or kill someone (slang)
itutulóy : [expression] To be continued...
maipagpatuloy : maipagpa- [verb] to be able to continue; to be able to carry on
pagpapatuloy : [noun] continuation; extension
makituloy : maki- [verb] to stay somewhere temporarily
makapagpatuloy : makapag- [verb] to be able to continue; to be able to proceed

tumawag : -um- [verb] to call; to summon; to phone
tawagin : -in [verb] to call on someone; to call out to someone (who is nearby); to hail someone; to be called something
tawagan : -an [verb] to call someone; to phone someone; to call someone by phone; to call someone (who is far away)
pantawag : [noun] credits for making a call
pánawagan : [noun] call to action; appeal
ipatawag : ipa- [verb] to have someone be called; to call for someone; to summon someone; * focus on the person/people being called for
itawag : i- [verb] to call someone something; to name something; to call about something; to call someone for someone else
manawagan : mang- [verb] to ask for help; to ask for cooperation; to appeal
tawag : [noun] call; name for
matawag : ma- [verb] to get called; to be summoned
magtawág : mag- [verb] to summon; to call on
pagtatawág : [noun] calling
mapatawag : mapa- [verb] to send for someone; to have someone sent for; to summon someone; to call (AF)
pagtawag : [noun] calling; the act of calling someone something
magtawagan : mag-an [verb] to call each other

tingnán : -an [verb] to look at something; to notice something; to view something; to investigate something; to look after something; to check something
pagtingín : [noun] looking; favor; attention; attitude
tingín : [noun] look; viewpoint; gaze; opinion; attention; diagnosis; esteem
tumingín : -um- [verb] to look at; to view; to behold; to investigate; to diagnose; to look after
paningín : [noun] vision; sight; view; sense of sight
nakatingín : [adjective] looking
patingín : [adjective] looking; [interjection] look!
magpatingín sa doktór : [verb] to see a doctor; to consult a doctor; to get a check up
mapatingín : mapa- [verb] to happen to look at; to happen to see; to suddenly look at
makatingín : maka- [verb] to be able to look
kung makátingín : [phrase] the way one stares at something
magkátinginan : magka-an [verb] to look at one another
magpatingín : magpa- [verb] to be examined; to consult; to seek the advice of someone
magtinginan : mag-an [verb] to look at one another
pakitingnán : paki-an please look at (something)

makita : ma- [verb] to be able to see something; to see something; to catch sight of something
kitá : [pronoun] you are to me; I verb you; I to you;
ipakita : ipa- [verb] to show someone something; to display something; to indicate; to demonstrate; * focus on the thing being shown
magkita : mag- [verb] to meet or see someone; to meet each other accidentally; to see each other (reciprocal)
kíta-kíts : [expression] See you!; See you later! (slang)
makakita : maka- [verb] to happen to see; to see; to see one or some or many; to be able to see; to catch sight of; to be able to find
magpakita : magpa- [verb] to show; to appear; to demonstrate; to indicate; to display; to show up
kítang-kita : [adjective] prominent; easy to see; obvious; noticeable
kumita : -um- [verb] to earn or make (money); to gain
pángitaín : [noun] vision; sight; premonition; apparition
kitain : -in [verb] to earn something; to meet up with someone
pinagkakákitaan : [noun] job; way of making money; earning a living
makipagkita : makipag- [verb] to meet up with
kita : [noun] earnings; profits; wages; income; seeing; see
maipakita : maipa- [verb] to be able to show something; to be able to display something; to be able to indicate something; to be able to demonstrate something
pagkikita : [noun] meeting
pagpapakita : [noun] showing; demonstrating
pagkakakitaan : [noun] earning a living
tamó : [expression] see?; do you see?; * contraction from "nakita mo"
Makikita mo! : [interjection] You'll see!
magpakítang-tao : magpa- [verb] to act humanely on the pretense
pagkakita : pagCV- [noun] observation; seeing; upon seeing
mapakita : mapa- [verb] to be able to show somethijg
mag-kíta-kita : mag- [verb] to see one another
makitaan : ma-an [verb] to demonstrate; to show

kasama : [noun] companion; housemate; associate; chaperone; comrade; anything that goes with something; [adjective] together with; fellow; accompanied with; staying with
samahan : -an [verb] to accompany someone; to be with someone
sumama : -um- [verb] to accompany; to go with; to join; to go along with
makasama : maka- [verb] to be able join someone; to be able to be with someone
samahán : [noun] organization; collective; group; company; corporation; guild; association
kasamahán : [noun] companion in a group or company; colleague
magkasama : magka- [verb] to be companions; to be together; to live together; to be associated with * plural verb
magsama : mag- [verb] to bring along; to take (someone) along; to unite; to combine; to blend; to consolidate; to embody; to live together
isama : i- [verb] to take something/someone along; to bring something; to incorporate something; to include something; to append something; * focus on the thing being included/taken along/incorporated
makisama : maki- [verb] to get along with
pagsasama : [noun] being together; marriage; companionship; coalition
sáma-sama : [noun] togetherness; being together; [adjective] together
magsáma-sama : mag- [verb] to flock; to stay together in a group
mapasama : mapa- [verb] to happen to be included or accidentally be included; to belong; to be one of; to convince someone to join
magkasama : [adjective] together; the two
pinagsáma-sama : [adjective] gathered; collected
pakikisama : [noun] Filipino concept of smooth interpersonal relations; adapting to others; getting along; company; society; companionship;
pagsamahin : pag-in [verb] to combine something; to have things put together / joined
pagsasáma-sama : [noun] merging
pagsama : [noun] accompanying someone; joining along; coming along
maisama : mai- [verb] to be able to take something/someone along; to be able to bring something; to be able to incorporate something; to be able to include something
makasama : maka- [verb] to be able to join
pinágsamahan : [noun] relationship; bond
kasáma-sama : [noun] constant companion

pahingá : [noun] rest; relaxation; relaxing; break; vacation; breather; downtime
magpahingá : magpa- [verb] to rest; to take a break; to take a rest
buntóng-hiningá : [noun] sigh
humingá : -um- [verb] to breathe
makapagpahingá : makapag- [verb] to be able to rest; to be refreshed
makahingá : maka- [verb] to be able to breathe
hingahán : -an [verb] to breathe on
bumuntóng-hiningá : [verb] to sigh
makapaghingá : makapag- [verb] to release or express displeasure (makapaghinga`` ng sama``` ng loo``b)
hinahabol na paghingá : [noun] breathlessness
hingá : [noun] respiration; breathing; wind
ihingá : i- [verb] to unload; to breathe out; to exhale
araw ng pahingá : [noun] day off; rest day; day of rest
hingahan : [noun] air hole; confidant
paghingá : [noun] breathing; respiration
maghingá : mag- [verb] to reveal one's feelings; to unburden
pamamahingá : [noun] leave (of absence)
pagpápahingá : [noun] rest; resting
mapabuntóng-hiningá : [verb] to sigh; to sigh involuntarily
hiningá : [noun] breath
hingahán : -an [verb] to reveal one's feelings to someone
ipahingá : ipa- [verb] to have something rest; to rest something (Ex: rest one's eyes)
ihingá : i- [verb] to reveal one's feelings about something

dumaán : -um- [verb] to pass; to pass by; to stop by; to drop in for a visit; to elapse; to go by
nakaraán : [adjective] past; previous; previously; former; bygone; recent
paraán : [noun] way; method; course of action; manner; manners
pamámaraán : [noun] method; way; approach; process
makaraán : maka- [verb] to be able to pass; to be able to get over/across
daanan : -an [verb] to pass through somewhere; to have access somewhere
pagdaanan : pag-an [verb] to go through something; to pass through something; to endure something (go through difficulties); to bring something by to someone
Makíkiraán pô : makiki- Please let me pass.
daán : [noun] hundred; one hundred (100); road; street; way; means; path; entry; course
idaán : i- [verb] to take something to; to deliver something; to convey something; to express something
magdaán : mag- [verb] to pass; to pass by; to drop by; to undergo; to go through
daanan : [noun] passageway; aisle
pagkaraán : [adverb] having passed; after something has passed; afterwards
madaanan : ma-an [verb] to happen to pass through somewhere
makidaán : maki- [verb] to ask permission to pass through
nagdaán : [adjective] passed; past
pagdaán : [noun] passing; going by; transit
daanin : -in [verb] to act indirectly
padaán : passing through; passing by
pagdáraanan : [noun] path
sandaán : [number] one hundred; * short for "isang daan"
madaán : ma- [verb] to happen to pass through
daan-daán : [adjective] hundreds
mapadaán : mapa- [verb] to happen to pass by
paraanin : pa-in [verb] to make way for something
isandaán : isa- [number] one hundred; * short for "isang daan".
idaán sa : i- [verb] to do something in a certain way
paraanan : pa-an [verb] to run through something
ikasandaán : ikasan- [adjective] one hundredth; 100th
kakaraán : [adjective] just passed by
tabíng-daán : [noun] roadside; wayside
bigyáng-daán : [noun] giving way

taás-noó : [adjective] with pride
itaás : i- [verb] to raise something; to lift something; to uplift something; to elevate something
mataasán : ma-an [verb] to outrank something/someone; to outgrow something/someone
tumaás : -um- [verb] to rise; to ascend; to become higher; to go upwards
taás : [noun] height; altitude; highness; up
itaás : [adjective] up; above; upper; upstairs; the top; [noun] upstairs
pataás : [adjective/adverb] upwards; upward
mataás : [adjective] high; tall; superior; elevated
taasán : -an [verb] to raise something; to increase something
pagtaás : [noun] rising; promotion; ascension; increase (in price)
pínakamataás : [adjective] highest; supreme; tallest (object)
makataás : maka- [verb] to precede; to be higher
pagtaasán ng boses : pag-an [verb] to raise one's voice to someone
pagmamataás : [adjective] arrogance
kátaás-taasan : [adjective] tallest; supreme
magtaás : mag- [verb] to raise; to elevate
magpataás : magpa- [verb] to cause to rise
pataasín : pa-in [verb] to raise
nakatataás : [adjective] highest; most elevated; highest rank
pang-itaás : [noun] blouse; top (clothing)
maitaás : mai- [verb] to be able to raise; to be able to lift; to be able to elevate;
mapataás : mapa- [verb] to be able to increase something
kataasan : [noun] height; elevation
paitaás : [adverb] towards the top
pataasan : [noun] a contest in which the person with the highest score wins
napataás : [adjective] raised
pagtataás : [noun] rising; promotion; ascension; increase (in price)
napakataás : [adjective] very high
sa itaás : [adverb] above
pataasán : pa-an [verb] to make something higher
pinakataás : [adjective] highest; tallest
dí-kataasan : [adjective] not tall; not high

ipagmalakí : ipagma- [verb] to be proud of something; to take pride in something
malakí : [adjective] big; large; much; a lot
lumakí : -um- [verb] to grow big; to become big; to get bigger; to grow up; to develop; to expand
pagmámalakí : [noun] pride; condescension
palakihín : pa-in [verb] to raise someone; to rear someone (a child); to bring up; to exaggerate; to blow out of proportion; to make something big
magpalakí : magpa- [verb] to raise; to rear a child; to bring up; to exaggerate; to blow out of proportion; to augment; to enlarge
napakalakí : [adjective] very big; huge; enormous; monumental
paglakí : [noun] progress; growth; growing up
kalakhán : [noun] bigness; greatness; [adjective] greater; metro-
kalakí : [adjective] big, in the phrase "gaano kalaki" = how big
mapagkalakhán : mapagka-an [verb] to outgrow; to grow too large for
ilakí : i- [verb] cause to grow
manlakí : mang- [verb] to enlarge temporarily; to expand; to swell; to grow bigger
lakihán : -an [verb] to grow something; to enlarge something
lakí : [noun] size; bigness; largeness
mapalakí : mapa- [verb] to grow something; to raise someone
pagpápalakí : [noun] expansion; upbringing; raising (child rearing)
hinlalakí : [noun] thumb
palakí : [adjective] raised by someone other than one's parents (even if the parents are still alive)
kalakihan : [noun] greatness; bigness
pínakamalakí : [adjective] largest; biggest
mas malakí : [adjective] bigger
pagkalakhán : pagka-an [verb] to grow up with
ang lakí-lakí : [adjective] extremely large; extremely big
kasinlakí : [adjective] as big as; equal in size
kasinlakí nang tao : [adjective] life-size
naglalakihán : [adjective] growing
maipagmalakí : maipagma- [verb] to be able to be proud of something; to be able to take pride in something
malakihán : ma-an [verb] to get bigger
malakí-lakí : [adjective] somewhat big; somewhat large

mapagkumbabâ : [adjective] humble
babà : [noun] chin; lowness; low
pagpápakumbabâ : [noun] humility
mababà : [adjective] low; lowly; down; [noun] bass
bumabâ : -um- [verb] to go down; to descend; to get off; to alight; to depreciate; to decrease; to become low; to become lower
magpakumbabâ : magpa- [verb] to humble oneself
ibabâ : i- [verb] to put something down; to bring something down; to lower something; to take something down; to degrade something; to demote something; to lower the position of something; to bring something downstairs
pagbabâ : [noun] descent; decadence; downgrade; stepping down (resignation)
hindí bábabá sa : [adverb] at least; not less than
kumbabâ : [noun] humility
ibabâ : [noun/adjective] bottom; beneath; below; down; downstairs
magbabâ : mag- [verb] to bring down; to demote
ngalumbabà : [noun] resting or supporting one's chin on one's hand or fist
pababâ : [adjective/adverb] downward; downhill
babâ : [noun] descent; down; [adjective] below (sa baba)
babaan : [noun] spot for unloading (people, things, packages, etc)
makababâ : maka- [verb] to be able to go down; to be able to descend
mapagpakumbabâ : [adjective] humble; modest
babaín : -in [verb] to go down for something; to put something down
nakababâ : [adjective] descended; down low; down
pababain : pa-in [verb] to reduce; to lower; to depreciate
pababaín : pa-in [verb] to get someone to descend
kababaan : [noun] lowness; lowliness
pagpápababâ : [noun] making lower; abasement
pinakamababà : [adjective] lowest
napakababâ : [adjective] very low
pinakababâ : [adjective] lowest
ipababâ : ipa- [verb] to have something brought downstairs or taken down
paibabâ : [adverb] downward
mababang loób : [adjective] humble

pagkakaisá : [noun] unity; alliance; harmony
isá't-isá : [phrase] each other; one another
isá-isahín : -in [verb] to do something one by one; to enumerate something
pakikiisá : [noun] solidarity; consolidation
makiisá : maki- [verb] to unite with; to become one with; to join in
mag-isá : [adverb] alone; single-handed; single-handedly; on one's own
nag-íisá : [adjective] alone; only; solitary; single; unique
isa pá : [noun] another; one more
magkáisá : magka- [verb] to unite; to be united; to have unity; to come together; to join together
isa't-isá : [phrase] each other
pag-iisá : [noun] loneliness; privacy; union
mag-isá : mag- [verb] to be alone; to do something alone; to be the only one
isá : [number] one; [article] the indefinite article "a/an"
kaisá : [adjective] one with; consistent with; in accordance with
isa-isá : [adverb] one by one; one at a time
kaisahán : [noun] oneness
maisahán : ma-an [verb] to outmatch someone
isahan : [adjective] singular; one at a time; [adverb] one by one
pagkáisahán : pagka-an [verb] to gang up on; to be ganged up on; to have consensus
bawa't isá : [adjective] each; everyone; each one's
káisa-isá : [adjective] lone; only; sole
íisá : [adjective] only one; single; one and the same
tig-isa : [adjective] one each
mapag-isá : [adjective] alone
ikalabing-isá : [adjective] eleventh
labing-isá : [number] eleven (11)
isahín : -in [verb] to do two things at once
ikalimampú't isá : [adjective] fifty-first

malaman : ma-an [verb] to know something (OF); to find out something (OF); to learn about something (OF); to be conscious of something (OF); to be informed (AF); to find out (AF)
waláng paké : [phrase] without a care (short for "walang pakialam")
Walá kang pakialám! : [phrase] It's none of your business!
hindí ko alám : I don't know
pakialám : [noun] give a care; care; meddler; interferer
alám : [adjective] know; known; familiar; revealed; aware; conscious; [noun] knowledge; something known
pakialamán : paki-an [verb] to meddle with; to disturb someone
alám ko : [phrase] I know
alamín : -in [verb] to find out something; to figure out something; to know something; * focus on the thing known/to be known
paké : [noun] care (contraction of "pakialam"); concern
Anóng pakí mo?! : [interjection] What's it to you?; Why are you asking?; Why do you want to know?
kinalaman : [noun] connection to something; regarding; a share (of something); knowledge about something
kaalamán : [noun] knowledge; information; intelligence; idea; statistics
makialám : maki- [verb] to meddle; to interfere
maalam : [adjective] knowledgeable; wise; well-versed
mapag-alamán : mapag-an [verb] to come to realize something; to come to learn something; to come to find out something
pagkakáalám : [noun] understanding
pakialamero : [noun] meddler
lákompaké : [expression] I don't care; * short for "wala akong pakialam"
makaalám : maka- [verb] to be able to know
wapakéls : [expression/slang] I don't care; None of my business; Short for "Wala akong pakialam"
umalám : -um- [verb] to know
kaalám-alám : having any knowledge (of something)
waláng alám : don't know
waláng kaalám-alám : know absolutely nothing; haven't the faintest idea; have no idea; have no clue
nakaaalám : naka- [adjective] knows; knowing
waláng pakialám : don't care

lakbay-aral : field trip
pag-aaral : [noun] studies; education; learning
balík-aral : [noun] review (of educational or informative materials)
mag-aral : mag- [verb] to study; to learn
aralin : -in [verb] to study something
takdáng aralín : [noun] homework; assignment
pag-aralan : pag-an [verb] to study something
páaralán : [noun] school
mág-aarál : [noun] students; class
kamag-arál : [noun] fellow student; classmate
pangaral : [noun] sermon; moral lecture; lecture; moral advice; admonishment; exhortation
makapag-aral : makapag- [verb] to be able to study
aral : [noun] lesson; studies
mataás na páaralán : [noun] high school
paláarál : [adjective] studious
aralín : [noun] lesson; instruction; something to study
silíd-aralán : [noun] classroom; study room
pagbabalík-aral : [noun] review; lesson review
gradwadong pag-aaral : [noun] Graduate School
arál : [adjective] educated; trained; learned; well-informed
mangaral : mang- [verb] to preach; to give earnest advice
páaraláng pribado : [noun] private school
pangaralan : pang-an [verb] to advise someone
kápapangaral : [noun] the constant act of admonishing or exhorting
magpaaral : magpa- [verb] to send someone to school
napag-aralán : [noun] studies; scholastic study

gawín : -in [verb] to do something; to make something; to create something; to service something; to repair something
gumawâ : -um- [verb] to do; to make; to produce; to engineer; to build; to create
gawâ : [noun] something made; made of; work; action; act; doing; deed; product; artistic work; task; duty; [adjective] manufactured by; written by; caused by; due to; on account of
magawâ : ma- [verb] to be able to do something (OF); to be able to make something (OF); to be able to fix something (OF); to be able to do (AF); to get fixed (AF)
manggagawà : [noun] worker; laborer
magagawâ : [adjective] feasible; practical
gawain : [noun] assignment; activity; enterprise; occupation; operation; task; chore; way; business; work; doings
paggawâ : [noun] manufacturing; making; doing; accomplishing; employment; labor
ipagawâ : ipa- [verb] to have or make someone fix or repair something; to have or make someone do something
káwang-gawâ : [noun] charity
isagawâ : isa- [verb] to execute something (an action/plan/etc); to perform an action; to implement something; to have something happen
makagawâ : maka- [verb] to be able to do; to be able to make; to be able to carry out; to be able to work; to achieve
igawâ : i- [verb] to make something for someone
gumagawâ : [noun] repairman; technician
gawán : -an [verb] to make something for someone; to do something for someone; to do something on/toward something else
magpagawâ : magpa- [verb] to have something done; to have something built
magsagawâ : magsa- [verb] to perform; to carry out; to perpetrate
kagagawán : [noun] doing; responsibility for an undesirable act
maggawâ : mag- [verb] to make; to manufacture
maygawâ : [noun] creator; maker; author
págawaan : [noun] factory
kámanggagawà : [noun] co-worker
pagpapagawâ : [noun] construction; building; creating
pagawaín : pag-in [verb] to make someone do something; to have someone do something
panggawâ : [noun] anything used for making something

nakákatawá : [adjective] funny; causing laughter; laughable; jocose; witty; comical
tumawa : -um- [verb] to laugh; to smile
palatawá : [adjective] likes to laugh; laughs a lot; prone to laughter
tawáng-tawá : [noun] laughing hard;strong laughter
makatawa : maka- [verb] to be able to laugh
matawá : ma- [verb] to laugh; to be amused; to grin
tawa : [noun] laughter; laugh; comedy
tawanan : -an [verb] to laugh at something; to smile at something
pagtawanán : pag-an [verb] to laugh at someone/something; to mock someone/something; to make fun of someone/something
patawá : [adverb] laughingly
magtawá : mag- [verb] to laugh out loud; to laugh
katawa-tawá : [adjective] comic; laughable; ridiculous; ludicrous;
katatawanán : [noun] joke; humor; comedy
nakatawa : [adjective] laughing
mapatawa : mapa- [verb] to burst out laughing; to break out in laughter; to be able to make someone laugh; to laugh involuntarily; to laugh despite oneself
táwanan : [noun] laughter; sound of laughing
magpatawá : magpa- [verb] to make someone laugh; to crack a joke
magtawanan : mag-an [verb] to laugh together; to laugh with others
makitawa : maki- [verb] to join in laughing
pagpapatawa : [noun] comedy; humor
pagtawa : [noun] laughing
katatawá : just laughing; was just recently laughing
matawa-tawá : [adjective] about to laugh
ikatawá : ika- [verb] to cause laughter

bumilí : -um- [verb] to buy; to purchase
bilhín : -in [verb] to buy something; * focus on the thing being bought
pambilí : [noun] money that will be used to buy something
mamilí : mang- [verb] to buy; to go shopping; to shop
bilhán : -an [verb] to buy something for someone (BF) - focus on the person being bought for; to buy something somewhere (LF) - focus on where something was bought
ibilí : i- [verb] to buy something for someone (BF); to purchase something for someone(BF); to buy with something (e.g., money) (IF)
mabilí : ma- [verb] to be bought; to happen to buy
pinamilí : [noun] purchase; purchased item; items purchased
mamimili : [noun] customer; client; buyer; consumer
bilihin : [noun] items for sale; merchandise; goods
makabilí : maka- [verb] to be able to buy
magbilí : mag- [verb] to sell; to deal
bilí : [noun] buying; price
ipagbilí : ipag- [verb] to sell something
ipabilí : ipa- [verb] to ask someone to buy something
pámilihan : [noun] market; exchange
pamimilí : [noun] shopping
pabilí : can I buy
pagbilhán : pag-an [verb] to sell to someone; to sell somewhere
pagbilí : [noun] buying; upon buying
mabilhán : ma-an [verb] to be able to buy something for someone
kakabilí : just bought; recently bought
maipagbilí : mai- [verb] to be able to sell
magpabilí : magpa- [verb] to have something bought; to have something be purchased

tumayô : -um- [verb] to stand; to stand up; to rise; to position oneself
itayô : i- [verb] to stand something up; to build something; to fabricate something; to establish something; to construct something; to set up something; to erect something
magtayô : mag- [verb] to set up; to build; to erect; to put up; to construct; to fabricate
katayuan : [noun] state; condition; standing
patayô : [adjective] vertical; erect
tayô : [noun] condition; social position; stance; standing up; building
nakatayô : [adjective] standing; situated
makatayô : maka- [verb] to be able to stand
patayuán : pa-an [verb] to have something put up / erected somewhere
kinatátayuán : [noun] position; location; standpoint; something stood upon
tayuán : -an [verb] to construct something somewhere; to build something somewhere; to erect something somewhere
pagpápatayô : [noun] standing up; building; erection (e.g., of a building); constructing
ipatayô : ipa- [verb] to have something constructed; to have something be built
makapagtayô : makapag- [verb] to be able to build
mapatayô : mapa- [verb] to stand involuntarily; to get up suddenly or unconsciously
pagtatayô : [noun] building or erecting a building; construction
magpatayô : magpa- [verb] to have built; to build
pagkakatayô : [noun] stance; construction
maitayô : mai- [verb] to be able to build something; to be able to stand something up; to be able to establish something; to be able to construct something; to be able to set up something
pagtayô : [noun] standing up; standing

basahin : -in [verb] to read something
basahan : -an [verb] to read to someone; * focus on the person being read to
magbasá : mag- [verb] to read; to read intently; to study a text; to read out loud
pagbasa : [noun] reading
bumasa : -um- [verb] to read
magbasa-basá : mag- [verb] to browse (while reading); to browse through; to skim (text)
mabasa : ma- [verb] to read something; to happen to read something; to be able to read something
mámbabasá : [noun] reader
babasahín : [noun] reading material
pagbabasá : [noun] reading
ibasa : i- [verb] to read something for someone
makabasa : maka- [verb] to be able to read
ipabasa : ipa- [verb] to have something read
palabasá : [adjective] fond of reading; well read
pagkabasa : [noun] reading; upon reading; after reading
pakibasa : please read

basâ : [adjective] wet
pagbabasâ : [noun] wetting
basaín : -in [verb] to wet something; to splash something
mabasâ : ma- [verb] to get wet
basaan : [noun] wetting
basang-basâ : [adjective] sopping wet; drenched
mamasâ : mang- [verb] to get wet (AF); to become wet (AF)

kumain : -um- [verb] to eat
kainin : -in [verb] to eat something; * focus on the thing being eaten
kain : [noun] eating; eating food; consuming
hapág-kainán : [noun] table for eating together; dinner table
pagkain : [noun] food; the act of eating
makain : ma- [verb] to be able to eat something (OF); to happen to eat something (OF)
magkaín : mag- [verb] to devour; to eat often
pakainin : pa-in [verb] to feed someone; to allow others to eat; * focus on the one eating
kainan : [noun] eating together
kainan : -in [verb] to eat from something (a plate / a banquet / a dessert / etc. ); to eat somewhere
nakakain : [adjective] edible
makakain : maka- [verb] to be able to eat
magpakain : magpa- [verb] to feed someone; to allow others to eat
mákakain : [noun] something to eat
makikain : maki- [verb] to join others in eating; to eat with others; to eat together
kainán : [noun] eatery; place to eat; dining room
magpakain sa : magpa- [verb] to allow oneself to be fed to something or someone
pagpapakain : [noun] feeding
ipakain : ipa- [verb] to have something fed; * focus on the thing being given for food
kakakain : just (recently) ate
pakain : [noun] rations
makakainán : [noun] a place to eat

ináanák : [noun] godchild
anák-dalitâ : [adjective] born poor
kamag-anak : [noun] relative; kin
anák-anakan : [noun] foster child
ipanganák : ipang- [verb] to be born; to give birth to; * focus on the person being born
anák : [noun] son or daughter; offspring; child; gender-less word to refer to one's child
anák sa labás : [noun] bastard; bastard child; illegitimate child
bonák : [noun] stupid child; stupid kid; dumb kid; (slang)
bágong-panganák : [adjective] newborn
kapanganakan : [noun] birthday; nativity; birth
anakán : -an [verb] to produce a child; to spawn; to beget a child
anák na babae : [noun] daughter
anák-tilik : [noun] step-sibling; step-brother; step-sister
manganák : mang- [verb] to give birth
panganganák : [noun] giving birth; delivery of a child; childbirth
mag-anák : mag- [verb] to have a child; to breed; to produce offspring
anakín : -in [verb] to act as a sponsor in a baptism
mag-anak : [noun] family; the whole family; family members
anák na lalaki : [noun] son, male child
bugtóng na anák : [noun] only child
magkaanák : magka- [verb] to have a child; to have a baby
kaanak : [noun/adjective] relative; of the same family
anakán : [noun] familial lineage; lineage

sabihin : -in [verb] to say something; to tell something; to allege something; to declare something; * focus on the thing being said
sabi : [noun] said; stated; statement; according to; shorthand for the verb conjugation "sinabi"
masabi : ma- [verb] to say something; to be able to say something; to mention something; to comment on something
magsabi : mag- [verb] to say; to tell; to state; to mention; to make known; to allege; to declare
kasabihán : [noun] proverb; household word; expression; byword; saying; precept; idiom; adage
pagsabihan : pag-an [verb] to reprimand someone; to scold someone; to correct someone; to say something to someone; * focus on the person being talked to
sabihan : -an [verb] to tell something to someone; to give notice to someone; to admonish someone; * focus on the person being talked to
sábi-sabi : [noun] hearsay; rumor; myth
sabi ninó? : [phrase] said / says who? / who said?
ipagsabí : ipag- [verb] to spread the word around to someone; to tell anyone; to gossip to someone; to tell something on behalf of
pakisabi : [phrase] please tell; please say
pinagsasabí : [noun] allegation; assertion without proof
pasabi : [noun] sent message; notification
pagsasabi : [noun] saying; telling
sinabi : [noun] word; words; said
ipasabi : ipa- [verb] to have someone relay a message; to make someone say something; * focus on the thing said / the message given
waláng sinasabi : [adjective] mum; silent; with nothing to say
pagkasabi : [noun] saying something; saying
makapagsabi : makapag- [verb] to be able to say; to be able to tell/relay
magsabihan : mag-an [verb] to tell each other; to share with each other (by speaking);

labasán : -an [verb] to have a discharge/orgasm; to cum (slang/vulgar)
lumabás : -um- [verb] to come out; to go out; to get out; to emerge; to appear; to exit
palabás : [noun] show; movie; stage show; pageant; stunt; performance; exit; egress; going out; leaving; exiting
labás : [noun] outside; outdoors; exterior; out; edition; [adverb] out
ilabás : i- [verb] to take out something; to put something outside
labasan : [noun] exit; egress
palabasín : pa-in [verb] to send something out; to make something appear to be so
mailabás : mai- [verb] to be able to release; to be able to put something outside; to be able to draw out
makalabás : maka- [verb] to be able to go out; to be able to sneak out; to leak; to leak news
maglabás : mag- [verb] to bring out; to take out; to put out
labasín : -in [verb] to take something out (informal/slang)
paglabás : [noun] exit; release; appearance; appear; upon exiting
ipalabás : ipa- [verb] to show a film; to publish a show; to send out; to make something appear to be so; to ask to take out something
nakalabás : [adjective] outside; being out/outside
panlabás : [adjective] external; exterior; outdoor
kalálabasán : [noun] outcome; end result
paglalabás : [noun] announcement; appearance
maglabasan : mag-an [verb] to come out all together; to come out in a group
magpalabás : magpa- [verb] to allow out; to let out
pagpapalabás : [noun] release
kalalabás : just came out; just exited
maipalabás : maipa- [verb] to have something come out; to be able to show a film

mahirap : [adjective] poor (financially); difficult; hard to do; complex; laborious; cumbersome; arduous; [noun] poor person
mahirapan : ma-an [verb] to experience difficulty/hardship; to have a hard time; to suffer difficulties; to have difficulty; to find something difficult; to be difficult for someone; to have difficulty
kahirapan : [noun] poverty; hardship; suffering; adversity; discomfort; difficulty
paghirapan : pag-an [verb] to work hard for something; to strain for something
paghihirap : [noun] suffering; labor; hardship
hirap : [noun] difficulty; suffering; hardship
maghirap : mag- [verb] to experience difficulty; to suffer; to become poor
hirapin : -in [verb] to experience difficulty; to be poor
pahirap : [noun] burden; punishment
pahirapan : pa-an [verb] to cause someone/something difficulties; to give someone a burden
pahirapán : [adjective] torturous; painful
hirapan : -an [verb] to make difficult
pahiráp : [adjective] becoming poor; becoming hard to do
kahiráp-hiráp : [adjective] causing difficulty; difficulty
napakahirap : [adjective] very difficult
mahirap na kalagayan : [noun] difficult situation; predicament
humirap : -um- [verb] to become difficult
pahirapan : [noun] torture; pains
magpahirap : magpa- [verb] to cause difficulty; to cause trouble
hírap-hirap : [adjective] so hard; very difficult; very hard
pinakamahirap : [adjective] poorest; most difficult

katwiran : [noun] argument; reason; justice; explanation; excuse; reasoning
matuwíd : [adjective] straight; righteous; correct
pangangatuwiran : [noun] reasoning; logic; argumentation
tuwíd : [adjective] straight; direct; [adverb] straight; directly
tuwiran : [adjective] direct; straight forward; blunt
ituwíd : i- [verb] to straighten; to correct
tumuwíd : -um- [verb] to straighten; to become straight

sikát : [adjective] famous; popular; distinguished
sumikat : -um- [verb] to be popular or famous; to rise (sun); to shine (sun)
sikat ng araw : [phrase] sunshine
pasikat : [noun] showy
pinakasikát : [adjective] most famous
sikat : [noun] rising (sun, moon); splendor
napakasikát : [adjective] very famous; very well-known 

maunawaan : ma-an [verb] to be able to understand something; to be able to realize something
paunawà : [noun] notice; notification
unawain : -in [verb] to understand something; to realize something; to comprehend something; to decipher something
hindí pagkakaunawaan : [noun] misunderstanding; miscommunication
maunawaang lubós : ma-an [verb] to master; to understand fully
ipaunawà : ipa- [verb] to make someone understand
pang-unawà : [noun] understanding; comprehension
makaunawà : maka- [verb] to be able understand
di-pagkakaunawaan : [noun] misunderstanding; miscommunication
pagkaunawà : [noun] understanding
pagkakaunawaan : [noun] mutual understanding
kaunawaán : [noun] understanding

katay : [noun] slice of meat; butchering; cutting into pieces
kumatay : -um- [verb] to butcher; to cut meat
katayin : -in [verb] to slaughter something; to slaughter an animal; to kill something for food
magkatay : mag- [verb] to slaughter; to slaughter animals

batayán : [noun] basis; condition; [adjective] fundamental; basic
nakababatay : [noun] contingent
batay : [adjective] based on; according to;
bumatay : -um- [verb] to base; to depend on
ibatay : i- [verb] to base on
nakabatay : [adjective] based on
pagbatayán : pag-an [verb] to base something on
