Walâ nang tubig sa pitsél.	There isn't any more water in the pitcher.
Lálangóy akó sa dagat.	I will swim in the sea.
Nagpaalam siyá sa batà.	She said goodbye to the child.
Pinapuntá niyá akó sa Baguio.	He sent me to Baguio.
Hindî ko natagpuán si Cathy sa mall.	I was not able to find Cathy at the mall.
Nagsúsulát si John sa malakíng lamesa.	John is writing at a large table.
Sa Miyérkoles kitá bábayaran.	I will pay you on Wednesday.
Nais niláng manatili sa isla.	They want to stay on the island.
Kákatawanín ko ang mga katrabaho ko sa pulong.	I will represent my colleagues in the meeting.
Bumagsák si John mulâ sa silya.	John fell off the chair.
Magpahayág ka ng pagmamahál sa mga anák mo.	Express love for your children.
Madalás makatanggáp ng email si Juliet galing sa mga kaibigan niyá.	Juliet often receives emails from her friends.
Híhilingín natin ang mga pagbabago sa kompanyá.	We'll ask for changes in the company.
Maraming dahon ang bumábagsák galing sa mga punò.	Many leaves are falling from the trees.
Napahiyâ ka ba sa ginawâ ko?	Were you embarrassed by what I did?
Kailangan kong pumasá sa Calculus.	I need to pass Calculus.
Kung lálagnatín ka pag-uwî mo, sabihin mo sa doktór kung anó ang ginawâ mo.	If you develop a fever after returning home, tell the doctor what you did.
Binanggít ko sa kaniyá na naíinís ka.	I mentioned to her that you're feeling frustrated.
Nalungkót akó nang ihayág niyá ang resignasyón sa trabaho.	I felt sad when she announced her resignation from work.
Sinísimulán mo na bang mag-aral para sa exam?	Are you already beginning to study for the exam?
May naiiwan pang mantsá sa damít mo.	There's still a stain left on your clothes.
Dumaló si Shera sa mga pulong na ginanáp sa Pasay.	Shera attended the various meetings held in Pasay.
Kúkumpirmahín ko lang, may gustó ka ba sa akin?	I would just like to confirm, do you like me?
Naabutan mo ba si Charles sa canteen kanina?	Was Charles still at the canteen when you went there earlier?
Anó ang sinabi ng matandáng babae sa mga nagsísilbí?	What did the old woman say to those serving?
Nakuntento ka ba sa trabaho nilá?	Are you satisfied / happy with their work?
Nangunguna na si Venus sa botohán.	Venus is now leading the election.
Kinúkumpirmá ng lalaki ang pagkákakilanlán ng tumulak sa kaniyá.	The guy is confirming the identity of the person who pushed him.
Magdaán ka sa tindahan ni Mameng mamayâ.	Drop by Mameng's store later.
Gustó ng asawa ni Mary na magtrabaho sa Middle East.	Mary's husband would like to work in the Middle East.
Nakuntento ba siyá sa pagkain?	Was he satisfied with the food?
Idadaos sa Pilipinas sa Nobyembre ang SEA Games.	The SEA Games will be held in the Philippines in October.
Pumápasá ka ba sa Math?	Are you getting passing grades in Math?
Bakit hindî mo ibiníbigáy sa akin?	How come you're not giving it to me?
Bumalík akó sa lungsód matapos magsaka nang isáng dekada.	I returned to the city after cultivating a piece of land.
Nagháhanáp siyá ng makákatulong sa kaniyáng magsaka.	He's looking for someone who will help him with farming.
Alín sa mga kotse mo ang mas madalás mong sinásakyán?	Which one among your cars do you more often use?
Mamilí tayo ng mga regalo para sa Paskó.	Let's go and shop for Christmas gifts.
Si Arnold ang namunò sa pagtuturò sa amin.	It was Arnold who took the lead in teaching us.
Ayaw mo bang maniwalà sa akin?	Don't you want to believe me?
Kung may lagnát ka, manatili ka lang sa bahay.	If you have a fever, just stay home.
Sino ang tumulong sa iyó?	Who helped you?
Idinaos ang nakaraáng Miss Universe sa Bangkok.	The recent Miss Universe was held in Thailand.
Mahilig akó sa ice cream.	I am fond of ice cream. (I like ice cream, but don't necessarily want it right now)
Sino ang maglálagáy ng dekorasyón sa Christmas tree?	Who will decorate the Christmas tree?
Kinain ko kung anó ang inihain nilá sa akin.	I ate whatever they served me.
Naputol ang kable ng telépono dahil sa bagyó.	The telephone cable snapped because of the typhoon.
Kunin mo ang libró sa mesa.	Get/Take the book on the table.
Anó ang kákantahín mo sa programa?	What are you going to sing in the program?
Lumapit ka pa sa akin.	Come even closer to me.
Mahirap tangkaíng tumakas sa kulungan.	It's difficult to attempt to escape prison.
Ilagáy mo sa channel 6 ang TV.	Switch the TV to channel 6.
Mamumunò akó nang may integridád kapág nanalo akó sa halalan.	I will lead with integrity if I win the elections.
Magpápahayág bukas si Kylie tungkól sa tsismis.	Kylie will talk about the rumor tomorrow.
Sino ang kumanâ sa laban?	Who dominated the match?
Bábagsák yatà akó sa exam.	I think I would fail the exam.
Búbuuín niláng mulî ang kaniláng relasyón sa Amérika.	They will rebuild their relationship in America.
Púpuntá kamí sa mall kasí makíkipagkita kamí kay Tony.	We are going to the mall because we will meet up with Tony.
Sa 1996 Atlanta Olympics, nagwagî siyá ng bronze medal.	At the 1996 Atlanta Olympics, he won a bronze medal.
Sumasabak silá sa marahás na labanán.	They're plunging into a violent battle.
Ihahain ko ang pagmamahál ko sa iyó.	I will offer my love to you.
Ilán lang ang nasagót mo sa exam?	How many were you able to answer in the exam?
Anó ang tinugtóg mo sa recital?	What did you play at the recital?
Pumilì ka ng apat sa kanilá.	Choose four out of them.
Anó ang biníbilí ni Jane sa mall?	What is Jane buying at the mall?
Lumapit siyá sa akin.	She approached me (about something). / She came closer to me.
Tinuruan ba kayó ng Spanish sa high school?	Were you taught Spanish in high school?
Sa artíkuló, tinagurián ang Palawan bilang pínakamagandáng isla sa mundó.	In the article, Palawan was named as the most beautiful island in the world.
Dapat matuwâ ka kasí nakapasá ka sa Algebra.	You should be thrilled because you passed Algebra.
Hiningî ng batà ang mga baryá sa bulsá ko.	The child asked for the coins in my pocket.
Nalúlungkót akó dahil mag-isá lang si Judy na nagpápaskó sa Hong Kong.	I feel sad because Judy is spending Christmas alone in Hong Kong.
Naitalâ na sa kasaysayan ang kasamaán ng mga diktadór.	History has recorded examples of dictators' atrocities.
Binuô niyá ang nobela niyá sa Portugal.	She completed her novel in Portugal.
Híhilingín ng grupo sa mga kandidato ang mapayapáng halalan.	The group will ask the candidates for a peaceful election.
Gustó kong idaos ang kaarawán ko sa Boracay.	I want to celebrate my birthday in Boracay.
Hindî makákapuntá si Bob sa party.	Bob won't be able to attend the party.
Tutukuyin nilá ang mga bagay na kailangan nilá sa kaniláng kasál.	They will specify the stuff they need for their wedding.
Natagpuán sa kuweba ang mga butó ng sinaunang tao.	The bones of a prehistoric human was discovered in the cave.
May kumakalat na tsismis tungkól sa iyó.	There's a rumor going around about you.
Itinuturò na ba ang Calculus sa high school?	Is Calculus already being taught in high school?
Marami ang hindî natátanggáp sa Harvard.	Many are denied admission to Harvard.
Nakákasama ko na siyá sa mga proyekto.	I've been with him in projects.
Humantóng sa karahasán ang pagseselos ni Raymart.	Raymart's jealousy ended in violence.
Anó ang hiníhilíng nilá sa kaniláng pinuno?	What do they require of their leader?
Nagseselos ka ba sa amin?	Are you jealous of us?
Gustó mo bang mapuntá sa kulungan?	Do you want to end up in jail?
Magtátapós na siyá sa pagiging binatà.	He'll soon graduate from being a bachelor.
Tutukuyin ni Ted sa kaniyáng artíkuló ang nang-abuso sa batà.	Ted will identify the child abuser in his article.
Nakasama ko si Joseph sa palengke kaninang umaga.	I was with Joseph at the market earlier this morning.
Sa Linggó ang piyesta.	The fiesta is next Sunday.
Ipopóst nilá mamayâ sa Instagram ang mga larawan.	They will post the pictures on Instagram later.
Itagò mo itó sa loób ng aparadór.	Put this inside the closet.
Hindî binábanggít sa libró ang kalupitán ng Amérika.	The book doesn't mention America's atrocities.
Ayaw niyáng katawanín sa korte ang mga kriminál.	She doesn't want to represent criminals in court.
Nakalayà siyá ngunit hindî niyá mapatawad ang mga dumakíp sa kaniyá.	She was freed but she couldn't forgive her kidnappers.
Nagbakasyón si Amy ng iláng araw para makabawì sa kaniyáng pagpápahingá.	Amy took a few days off to catch up on her rest.
Sinásabayán ko si Alice magtanghalian sa canteen.	I join Alice for lunch at the canteen.
Naupô si Rose sa tabí ko.	Rose sat beside me.
Madalî siyáng nakabawì mulâ sa pagkabigo.	She recovered quickly from setbacks.
Si Jonas ang tumalo sa mayabang na kalahók.	Jonas was the one who defeated the arrogant participant.
Sa restawrán o sa bahay?	At a restaurant, or at home?
Walâ sa bahay ang dadalawin namin.	The person we're visiting is not at home.
Kapág sumásakáy akó sa bus, mas gustó kong nauupô sa bandáng harapán.	When I ride a bus, I prefer to sit at the front part.
Sa dami ng ating trabaho anóng oras na kayâ tayo makákauwî?	With so much work to be done, I wonder what time we'll be able to go home.
Hindî ka ba nanghíhinayang sa oras na nauubos mo sa Facebook?	Don't you regret using up so much time on Facebook?
Dito ka sa lilim para hindî ka masunog sa araw.	Stay here under the shade so you won't get sunburned.
Sino ang gagastos para sa kasál ninyó?	Who's going to foot the bill for your wedding?
Tumaás ang ( mga ) kilay ni Vicky sa sinabi ni Angie.	Vicky raised her eyebrows at what Angie said.
Napag-usapan na ba ninyó ang gágawín ninyó sa Linggó?	Have you already talked about what you will do on Sunday?
Nabanggít nga pala ni Alice na bakâ hindî siyá makapuntá sa kasál mo.	By the way, Alice mentioned that she may not be able to go to your wedding.
Tútulóy ka pa ba sa plano mong bumilí ng kotse?	Would you still proceed with your plan to buy a car?
Natulóy ba kayóng magpuntá sa beach nung Sábado?	Were you able to go to the beach last Saturday?
Matulóy kayâ ang planong pagpuntá ni Laura sa America?	Do you think Laura's planned trip to America will materialize?
Magsuót ka ng máskará sa Halloween para makapanakot ka.	Wear a mask on Halloween so that you may be able to scare people.
Anó ang biníbilí ni George kapág pumúpuntá siyá sa Hong Kong?	What does George buy whenever he goes to Hong Kong?
Nagkamalî akó ng ináakalà tungkól sa iyó.	I was wrong with my assumptions about you.
Huwág mong kákalimutan ang mga itinurò ko sa iyó.	Don't forget the things that I taught you.
Pangarap ni Jim na makabilí ng Ferrari sa isáng taón.	Jim dreams of being able to buy a Ferrari next year.
Ginastos mo bang lahát yung perang ibinigáy ko sa iyó?	Did you spend all the money that I gave you?
Hindî kitá mabigyán nitó kasí hindî itó sa akin.	I can't give you any of these because these are not mine.
Hindî kinaya ni Charles ang lamíg sa Alaska kayâ lumipat siyá sa California.	Charles could not endure Alaska's cold temperaure that's why he moved to California.
Mangínginíg ka sa gináw sa itaás ng bundók.	You will shiver in the cold at the top of the mountain.
Manghinayang ka sa perang ináaksayá mo sa sigarilyo.	You should feel sorry for the money you're wasting on cigarettes.
Nagbakasyón si Maria sa Amérika pero iláng araw pa lang ang nakákalipas umuwî na siyá.	Maria went to America for vacation but just after a few days she already came back home.
Sino ang nilálapitan mo kapág may problema ka sa pera?	Whom do you approach for help when you have money problems?
May mga umaakyát sa Mt. Everest na hindî na nakákabalík.	There are some who climb up Mt. Everest and don't come down anymore.
Mámahalín mo ang mga bagay na ibiníbigáy sa iyó ng lola mo.	You should treasure the items that your grandma gives you.
Lumipád ang pera ni Bob sa casino.	Bob's money went to waste at the casino.
Ingat sa aso!	Beware of the dog!
Tayo sa tsahan!	Let's go to the teahouse!
Ipakita sa akin.	Show me.
May baso sa mesa.	There is a glass on the table.
Adik siya sa alak.	She is addicted to alcohol.
HIndi ito sa akin.	This is not mine.
Ipakita mo sa akin.	Show me.
Salamat sa hapunan.	Thanks for the dinner.
Umupo siya sa kama.	He sat on the bed.
May bahay sa burol.	There is a house on the hill.
Wala siya sa bahay.	He's not at home.
Manatili ka sa loob.	Stay inside.
Mahilig ako sa tula.	I have an inclination for poetry.
Humiga siya sa kama.	He lay down on the bed.
Di ako takot sa iyo.	I'm not afraid of you.
Wala sa loob si Tom.	Tom isn't inside.
Anong palabas sa 10?	What is on Channel 10?
Galing ako sa Olanda.	I come from Holland.
Nadapa siya sa sahig.	He fell down on the floor.
Hindi malayo sa otel.	It is not far away from the hotel.
Sumagot ka sa Ingles.	Answer in English.
Ipakita niyo sa akin.	Show me.
Magintay ka sa labas.	Wait outside.
