Saán kayó nakatirá?	Where do you all live?
Saán ka?	Where are you?
Saán ka púpuntá?	Where are you going? / Where are you headed? / Where will you be going?
Saán ka pumapasok?	Where do you work/go to school?
Tága-saán ka?	Where are you from?
Saán ang ATM?	Where is the ATM?
Saán ang aso?	Where is the dog?
Saán ka nakatirá?	Where do you live?
Saán mo gustóng kumain?	Where would you like to eat?
Saán mo akó pápakainin?	Where are you going to treat me (to a meal)?
Kailán at saán kayó nagpakasál?	When and where did you get married?
Saán ka nanganák?	Where did you give birth?
Saáng parté ng sinehán mo gustóng maupô?	At which section of the movie house do you like to sit?
Saán ka nagtátrabaho?	Where do you work?
Saán ka nag-aral?	Where did you go to school?
Mahirap hulaan kung saán siyá nanggaling.	It's difficult to surmise where she came from.
Húhulaan ko kung saán ka nanggaling / galing.	Let me guess where you just came from.
Saán ka bumíbilí ng mga sapatos mo?	Where do you buy your shoes?
Saán ka magpápaskó?	Where will you celebrate Christmas?
Hanggáng saán ba ang sakláw ng teritoryo ng Tsina?	How far is the scope of China's territory?
Saán akó uupô?	Where should I sit?
Saán mo nabábatíd ang mga pangyayaring itó?	Where do you learn about these events?
Saán mo iniwan ang libró ni Luke?	Where did you leave Luke's book?
Saán mo gustóng magpuntá?	Where would you like to go?
Saán tumae ang pusà?	Where did the cat defecate?
Saán ninyó siyá yayayain?	Where to will you invite him to join you?
Saán tayo magsísimulâ?	Where are we going to begin?
Saán bandá ang silang ng araw?	Where will the sun rise?
Saán kinunan ang pelíkulá?	Where was the movie shot?
Saán ka nagtagò?	Where did you hide?
Saán pô puwedeng umihì?	Where can I go to the bathroom / pee? (polite)
Saán mo gustóng humintô tayo?	Where would you like us to stop?
Saán mo iyán nabasa?	Where did you read that?
Saán kitá súsunduín bukas?	Where shall I pick you up tomorrow?
Saán ko itó itatagò?	Where should I keep / hide this?
Itinatakdâ ba ng kompanyá kung saán at kailán dapat kumain?	Does the company limit our lunch to certain places and times?
Saán ka nagtatapon ng basura?	Where do you dispose of the garbage?
Saán ko mapápanoód ang pelíkulá?	Where can I watch the film?
Saán ka títirá sa Chicago?	Where will you be staying in Chicago?
Saán ka magtutungo ngayón?	Where are you headed now?
Saán mapúpuntá ang sinungaling pagkamatáy niyá?	Where would the liar go after she died?
Saán ka natulog?	Where did you sleep?
Saán ka nagtungo?	Where did you go?
Saán ka man magtungo, súsunód akó.	Wherever you may go, I will follow.
Saán ka magtátrabaho?	Where are you going to work?
Saán mo gustóng idaos ang kaarawán mo?	Where do you want to celebrate your birthday?
Saán mo itinátabí ang asukal?	Where do you keep the sugar?
Saán nakákabilí dito ng cell phone?	Where can I buy a cell phone around here?
Saán kayó naglalarô ng basketball?	Where do you play basketball?
Saán kayó kasalukuyang nanínirahan?	Where are you currently residing?
Saáng bangko ka nagbukás ng account?	At which bank did you open an account?
Saán mo gustóng mapuntá?	Where do you want to end up?
Saán gúgunitaín ang anibersaryo ng kamatayan ni Larry?	Where will the Larry's death anniversary be commemorated?
Saán ang daán papuntáng palengke?	Where is the way to the market?
Saán tayo magkikita?	Where will we be meeting up?
Saán mo inilagáy ang bag?	Where did you put the bag?
Saán mo siyá pinaupô?	Where did you tell him to sit? / Where did you make him sit?
Saán mo gustóng gumalà tayo?	Where would you like us to go (for leisure)?
Saáng bandá ng katawán itó makikita?	On which part of the body can you see this?
Saán ka nag-aral ng karate?	Where did you learn karate?
Saán ka nagpápagupít?	Where do you go for a haircut?
Saán tayo makákahanap ng proteksiyón ngayón?	Where can we find protection today?
Saán tayo tátawíd?	Where will we cross the street?
Hanggáng saán ang dapat kong ipangambá kapág nilagnát ang anák ko?	How worried do I need to be if my child has a fever?
Saán nakatirá ang pamilya mo?	Where does your family live?
Saán akó puwedeng kumuha ng taksi?	Where can I get a taxi?
Saán matátagpuán ang pinakamahabang ilog sa buóng mundó?	Where can you find the longest river in the whole world?
Hindî ko maalala kung saán ko naiwan ang susì ng kotse.	I can't remember where I left the car key.
Saán pa ninyó gustóng dalhín ko kayó?	What other places would you like me to take you to?
Ináalala ko kung saán ko náilagáy ang susì ng kotse.	I am trying to remember where I placed the car key.
Saáng eskuwela mo ipinasok ang anák mo?	At which school did you enroll your child?
Saan?	Where?
Para saan?	What for?
Galing saan?	From where?
Saan ka pupunta?	Where are you going?
Uy, saan ka galing?	Hey, where've you been?
Saan ka nanggaling?	Where have you been?
Saan iyon nangyari?	Where did it happen?
Saan kayo nagsusulat?	Where do you write?
Saan mo sila pinakain?	Where did you feed them?
Alam ko kung saan tayo.	I know where we are.
Saan nalaman ni Tom iyon?	Where did Tom learn that?
Sino ka at saan ka galing?	Who are you and where do you come from?
Saan mong gustong pumunta?	Where do you want to go?
Saan ka magaaral ng Aleman?	Where are you going to learn German?
Saan nakatayo ang katedral?	Where is the cathedral located?
Saan ka nanuod ng telebisyon?	Where do you watch television?
Saan naalis ang bus ng erport?	Where does the airport bus leave from?
Saan puwedeng mamili ng libro?	Where can one buy books?
Gusto mo ba ang San Francisco?	Do you like San Francisco?
Alam mo saan ko mahahanap iyon?	Do you know where I can find it?
Saan ang dapat nating puntahan?	Where should we go?
Alam mo kung saan ako nakatira?	Do you know where I live?
Kung saan may buhay, may pag-asa.	Where there is life, there is hope.
Kung saan may buhay, may pag-asa.	Where there's life, there's hope.
Alam ko kung saan siya nanggaling.	I know where he comes from.
Alam mo ba kung saan tayo pupunta?	Do you know where we're going?
Saan mo nakita ang mga babaeng iyon?	Where did you see those women?
Hindi ko alam kung saan magsisimula.	I didn't know where to begin.
Saan natin matatagpuan ang katotohanan?	Where will we find the truth?
Sinabi niya sa akin kung saan mamalengke.	He told me where to shop.
