a breaking of the law of God	 kasalanan, pagkakasala, paglabag sa utos ng Diyos 
a certain series of years, an era	 panahon, kapanahunan 
a command, telling what to do	 utos, kautusan, orden, atas 
a condition in which every part or piece is in its right place	 ayos, kaayusan, pagkakaayos 
a condition of being satisfied or pleased and contented	 kasiyahan, kasiyahan, lugod, kaluguran 
a condition of being without something desired or needed, lack, need	 kulang, kakulangan, kailangan, pangangailangan, kawalan 
a condition, state	 lagay, kalagayan 
a desire	 nais, pagnanais, nasa, pagnanasa, gusto, gusto, kagustuhan, ibig, kaibigan 
a disordered condition, as of a machine	 sira, kasiraan, pagkasira, depekto 
a disposition or feeling towards another	 kalooban, kalooban, palagay, pagpapalagay 
a habit, custom	 ugali, kaugalian, kinabihasnan, kilos, gawi, kinagawian 
a just claim, something that is due to a person	 karapatan 
a lasting quality, service	 tibay, katibayan, serbisyo
a level	 lagay, kalagayan, pamantayan, antas 
a long stretch or extent	 lawak, kalawakan
a manner, style	 moda, uso, kalakaran 
a means, method	 paraan, pamamaraan, kaparaanan 
a mental picture, an idea	 kaalaman, kabatiran, idea
a mistake	 mali, pagkakamali, kamalian 
a payment	 bayad, kabayaran, upa, kaupahan 
a period of time, season	 panahon, kapanahunan 
a reason that is given	 dahilan, katwiran 
a short time ago	 kamakailan lamang, kailan lamang 
a social position, rank	 lagay, kalagayan, tayo, katayuan 
a special character or disposition, state of mind, mood	 hilig, ugali, lagay ng kalooban (kalooban)
a state, condition	 katayuan, tayo, kalagayan, lagay 
a suitableness or adaptability to an end	 gamit, kagamitan 
a system of measurement	 panukatan, sukatan, takalan, batayan ng sukat (timbang)
a thing desired or needed	 ibig, kaibigan, gusto, gusto, kagustuhan, kailangan 
a violent disturbance or disorder	 gulo, pagkakagulo, kaguluhan
a wish, desire	 nais, nasa, pita, hangad, gusto, gusto, kagustuhan, ibig, kaibigan 
act of stealing (coll)	 pagnanakaw, pagkakanakaw, nakawan, pangungupit, pang-uumit 
actual	 mismo, kasalukuyan 
advantage	 buti, kabutihan, kapararakan 
advantage	 kapakinabangan, bentaha
advantage, benefit	 bentaha, kabutihan, pakinabang, kapakinabangan
advantage, benefit, use	 pakinabang, kapakinabangan, buti, kabutihan 
advantage, profit, benefit	 kapakinabangan, kapakanan, kabutihan 
after	 pagkatapos, matapos, pagkaraan, makaraan
although	 bagaman, bagamat, kahit na, kahit, kahiman, kahimat
an action	 gawa, kagagawan 
an error	 mali, pagkakamali, kamalian 
an experience	 karanasan 
an illness	 karamdaman, sakit, diperensiya 
an official account	 ulat, kasulatan, rekord 
antagonistic	 kalaban 
anything not right, a mistake	 kamalian, kasamaan, kasamaan, sala, kasalanan 
approving, agreeing	 umaayon, sumasang-ayon, nakikiisa, kasang-ayon 
as things are, as it is	 ngayon, sa kasalukuyan 
at a loss (in business)	 kalugihan
at ones service, ready to do what one wants	 nakalaan (nakahanda) sa paglilingkod 
at the same level	 kapantay, kasimpantay, kasintaas
at this time	 ngayon, sa kasalukuyan 
at what time	 kailan 
authority, control	 kapangyarihan
being heavy, great weight	 bigat, kabigatan 
being wise	 dunong, karunungan 
beside the question, off the subject	 labas sa pinag-uusapan, wala sa pinag-uusapan, di pinag-uusapan, walang kaugnayan sa paksa 
body	 katawan, pangangatawan 
causing great fear, dreadful, awful	 kakila-kilabot, nakakikilabot, kahila-hilakbot, nakapanghihilakbot, kasindak-sindak, nakasisindak, nakatatakot 
charge, money paid for service	 bayad, kabayaran 
circumference, the distance around	 bilog, kabilugan 
clothing	 mga damit, kasuutan 
coming after all others	 katapusan, huli, pinakahuli 
coming before, that came before	 una, nauuna, dati, nakaraan, lumipas 
common, ordinary	 karaniwan, pangkaraniwan 
common, ordinary, simple in manner	 pangkaraniwan, simple 
compassion, mercy	 awa, pagkaawa, habag, pagkahabag
with all ones heart, sincerely	nang buong puso, nang buong katapatan, nang tapat sa loob, nang taos-puso
competent, able (old use)	 may kaya, may kakayahan
conclusion	 tapos, katapusan, pagkatapos, wakas 
condition, order	 ayos, lagay, kalagayan, anyo
condition, state	 kaayusan, kalagayan 
confusion, disorder	 gulo, kaguluhan, pagkagulo, pagkakagulo 
constancy in work	 tiyaga, pagtitiyaga, katiyagaan
courage	 tapang, katapangan, lakas ng loob 
current, occurring now, at this time	 kasalukuyan, ngayon
darkness, deep shadow, dim light	 dilim, karimlan
death	 kamatayan, pagkamatay 
defeat in sports	 pagkatalo, katalunan 
defect	 sira, kasiraan, depekto 
difficult situation	 gipit (mahirap) na kalagayan, kagipitan 
diligence	 sigasig, kasigasigan, pagsusumikap 
distress	 kahirapan 
distress, worry, difficulty	 ligalig, kaligaligan, bagabag, pagkabagabag, balisa, pagkabalisa, hilahil, pagkahilahil 
disturbance	 gulo, kaguluhan 
document	 kasulatan, dokumento 
done or made not long ago	 bago, kamakailan lamang, di pa natatagalan, sariwa pa 
doubtful	 nakapagaalinlangan, di gaanong mapaniniwalaan, nakapagdududa 
ease of mind	 hinahon, kahinahunan
easy to get along with, friendly	 madaling pakitunguhan, kawili-wili, masayang kasama, pala-kaibigan 
elegance	 gara, kagaraan, kisig, kakisigan, dikit, kariktan
end	 wakas, katapusan
end	 wakas, katapusan, konklusyon 
entire	 buo, tanan, kabuoan 
equally distant from each end	 panggitna, nasa gitna (kalagitnaan) 
essential quality or character of a thing	 sariling katangian, katangiang kailangan 
excellence, usefulness, importance	 halaga, kahalagahan, saysay, kasaysayan, kabuluhan 
excellent, fine, splendid, magnificent	 napakaganda, napakarikit
extent	 lawak, kalawakan, lapad, kalaparan
extra work, bother, effort	 abala, kaabalahan, pagkaabala, gambala, kagambalaan, pagkagambala 
extreme degree, greatness	 tindi, katindihan, sidhi, kasidhian 
extreme fatigue	 kapaguran, pagkapagod, pagkakahapo, pagkapata, panlalata 
fair	 kainaman, katamtaman 
fairness	 katarungan 
fault	 sala, kasalanan
Filipina costume	 ang kasuutang Pilipina 
for the people, serving the people	 panlahat, pangkalahatan, pangmadla, pambayan, pangmamamayan 
fun	 tuwa, pagkatuwa, katuwaan 
funny quality	 katatawanan, pampatawa, pagpapatawa, pampatawa 
going right	 pakanan, kanan, pamano, mano
great brightness, brilliance	 ningning, kaningningan 
great vigor, strength	 lakas, kalakasan
grief or such emotion opposite of pleasure	 lungkot, kalungkutan, sama ng loob, hapdi ng kalooban (kalooban)
grief	 pighati, dalamhati, lumbay, hapis, lungkot, kalungkutan, sakit 
guiding, ruling, or governing ones self, not under anothers rule	 nagsasarili, malaya, may kasarinlan 
harm or disadvantage caused by losing something	 pinsala, kapinsalaan 
harm, injury	 pinsala, kapinsalaan 
having a middle position, quality, or condition	 katamtaman, kainaman, kaayusan, kaigihan, katatagan 
having its citizens represented by chosen persons	 kinakatawan ng mga piniling (halal na) tao 
having property that amounts to	 may kabuhayang pagkakahalaga ng
healthy, strong	 malakas ang katawan
height above the sea level	 ang taas sa kapantayan ng dagat 
her real or true self	 sarili, kanyang sarili 
high noon	 katanghalian, tanghaling tapat
his own self	 ang sarili, ang kanyang sarili
hurt, damage	 kasiraan, pinsala, kapinsalaan 
illness, poor health, disease	 sakit, pagkakasakit, karamdaman, pagkakaramdam 
importance	 halaga, kahalagahan
in anothers shoes, in anothers place, situation or circumstances	 nasa kalagayan (katayuan) ng iba 
in between, ordinary, average	 katamtaman, karaniwan, kaigihan
in fact	 sa katotohanan, sa katunayan 
in ones way, interfering	 nakasasagabal, nakahahadlang, humahadlang 
in poor health, having some disease	 may sakit, may karamdaman 
in reference to time	 kalahatian
in the pink (in sound physical condition (coll.))	 nasa mabuting kondisyon (kalagayan)
in wishes such as "May you be" or "God grant"	 kahimanawari, nawa 
industry	 sipag, kasipagan 
influence that stirs up and rouses	 sigla, kasiglahan 
influence, importance, value	 halaga, kahalagahan
instinctive behavior	 katutubong ugali (kaugalian), kalikasan 
instructions often means directions or orders	 tagubilin, atas, utos, kautusan
intensity	 sidhi, kasidhian 
judgment, intelligence	 talino, katalinuhan, isip, bait 
just conduct, fair dealing	 kawastuan, pantay na (parehong) pakikitungo
just contrary	 kasalungat, magkasalungat, kabaliktaran 
just spoken of	 nabanggit, (kababangit) lamang 
just	 makatarungan, matwid, maibigin sa katwiran
justice	 katarungan 
kindness, an act of generosity	 kagandahang-loob, kabutihang-loob, pabor 
knowledge and good judgement based on experience	 alam, kaalaman, kaalaman, talino, katalinuhan 
lack of order	 kawalang-ayos, kaguluhan 
lack of rain	 kakulangan sa ulan, kawalan ng ulan
legal right to the possession of	 titulo, katibayan (karapatan) sa pag-aari (pagkamay-ari) 
liveliness	 sigla, kasiglahan 
loss in a commercial venture	 pagkalugi, kalugihan 
lot, a number together	 bunton, tambak, barkada, kawan, pangkat, katerba 
low grassy land by the bank of a stream	 parang, kaparangan 
low spirits, sadness	 lungkot, kalungkutan, panglaw, kapanglawan, lumbay, kalumbayan 
material, what a thing is made of	 materyales, gamit, kagamitan, sangkap, panangkap 
meaning	 kahulugan, diwa
meaning	 kahulugan, kabuluhan, saysay, kasaysayan 
merit, usefulness, importance	 pakinabang, kapakinabangan, kagalingan, kasaysayan, halaga, kahalagahan, buti, kabutihan
minutes of a meeting	 katitikan minute (2.)
misfortune	 kasawiang-palad
misfortune	 kasawiang-palad 
misunderstanding	 di-pagkakaunawaan, di-pagkakaintindihan, 
mixed-up condition of things, tumult	 gulo, kaguluhan, pagkakagulo 
moral violence	 pusok, kapusukan, lupit, kalupitan
most	 kahuli-hulihan adv. 1. after all others	 kahuli-hulihan, pinakahuli, huli, katapusan 
municipal laws	 ordenansa, kautusangbayan
must, should, have to or ought to	 dapat, nararapat, kailangan, kinakailangan
natural talent, special ability	 likas na talino, katutubong kakayahan, pambihirang talino 
nearly equal	 halos pareho, hindi nagkakalamangan, mahigpitan 
necessity, something that has to be	 kailangan, pangangailangan
neglecting	 pagpapabaya, kapabayaan 
no use, no advantage, no good to be gained, useless	 walang kapakinabangan, walang kabutihan, walang kasaysayan, walang kabuluhan, walang kapararakan, hindi kailangan, inutil
noise, uproar	 ingay, kaingayan, kaingayan, pagkakaingay 
not ever, at no time	 hindi kailanman 
not having power or strength	 walang kaya, walang kapangyarihan 
not like, different	 di katulad, di magkatulad, di kawangis, di magkawangis, iba, magkaiba 
not meant to be seen, least important ( for cloth, etc., use the noun)	 kabaligtaran 
not neat, not in order	 magulo, hindi maayos, walang ayos (kaayusan) 
not needed, not necessary	 hindi kailangan
not pretty	 karaniwan (pangkaraniwan) ang ganda, hindi maganda 
not rich	 karaniwan, simple, di marangya 
not sure, not definite	 hindi tiyak, walang katiyakan
not susceptible	 hindi tinatablan o kinakapitan 
not true	 hindi totoo, walang katotohanan 
now and then, or now and again, from time to time, once in a while	 paminsanminsan, maminsan-minsan, kung magkaminsan
now, the time being	 ngayon, kasalukuyan 
of equal height, importance, etc.	 kapantay, magkapantay, magkakapantay, kasintaas, magkasintaas, kapareho, magkapareho
of highest excellence	 katangi-tangi exterior
of no use, worthless	 walang kasaysayan, walang kaukulan, walang kuwenta, walang silbi, inutil, walang kagamitan 
of or about nature	 ng (tungkol sa) kalikasan
of the mind	 pagkalito, pagkataranta
once and for all, finally or decisively	 wakasan, minsan na lamang, minsan pa, katapusan na 
ones wish, will	 gusto, gusto, kagustuhan, ibig, sariling kalooban, sariling gusto 
opposed, opposite	 laban, kalaban, salungat, kasalungat, kontra, kakontra 
order of the day, the way things are, the way people are doing things, the style	 kalakaran, moda, uso, takbo 
outer dress	 damit, kasuutan 
past, long past	 nakaraan, una
payment for things bought	 bayad, kabayaran 
persistent in wrong	 mapilit sa kamalian (kasalanan), nagmamatigas sa pagkakamali (pagkakasala) 
perturbed condition	 kaligaligan, kaguluhan, kabalisahan 
pomp	 dilag, karilagan, dingal, karingalan, rangya, karangyaan 
poverty	 kasalatan, pagsasalat, karalitaan, pagdaralita, paghihikahos, kahirapan, paghihirap
power to work or act, force	 lakas, kakayahan
power	 kapangyarihan
power	 kapangyarihan 
present tense (in grammar.)	 panahong kasalukuyan (pangkasalukuyan)
present	 kasalukuyan
profit	 pakinabang, kapakinabangan 
punishment	 parusa, kaparusahan 
qualifications	 kaya, kakayahan
quiet, freedom from anything that tires, troubles, disturbs, or pains	 ginhawa, kaginhawahan, katiwasayan 
quietness, stillness	 katahimikan 
raised place, high place	 kataasan 
range, power, capacity	 abot, kaya, kakayahan, kapasidad 
recent	 nakaraan, dumaan, kararaan, huli, di pa natatagalan 
representing the people	 kumakatawan sa mga tao, kinakatawan ng mga tao 
requirements, need	 kailangan, pangangailangan 
respect, particular	 paraan, kaparaanan, bagay 
right position, usual position	 tamang lugar (lugal), karaniwang lugar (lugal), tumpak na ayos 
right, claim	 karapatan
right, correct, reasonable, reliable	 tama, tumpak, makatarungan
rightful, just	 matuwid, matwid, tumpak, tama, makatarungan 
rightful, lawful	 tunay, legal, may karapatan 
rightness	 katwiran, katumpakan 
rough or harmful action or treatment	 dahas, karahasan, pagkamarahas, lupit, kalupitan, pagkamalupit 
rule, regulation	 patakaran, tuntunin, alituntunin 
sadness	 lungkot, kalungkutan, lumbay, kalumbayan 
share (having something to do with the act of others)	 kinalaman, kaugnayan 
sickness	 karamdaman, sakit 
sickness, poor health	 sakit, karamdaman 
sight	 tingin, pagkakita, pagkatanaw 
sin, misdeed or violation	 sala, kasalanan, pagkakasala 
something that is asked	 tanong, katanungan, ang itinatanong 
sorrow	 lungkot, kalungkutan, lumbay, kalumbayan 
special quality or feature	 katangian 
state of mind, disposition	 damdamin, loob, kalooban, kalooban, disposisyon 
state or condition of things in which the law is obeyed and there is no trouble	 katiwasayan, katahimikan 
steady effort	 sipag, kasipagan, sikap, pagsisikap, tiyaga pagtitiyaga 
steady effort, perseverance	 tiyaga, pagtitiyaga, katiyagaan
stillness, quiet	 katahimikan
street costume	 kasuutang panlakad
style, build, character	 yari, kayarian, pagkakayari 
sufficient	 kainaman, katamtaman adv. sufficiently	 nang sapat
sufficiently like all those of its kind to stand for all the rest	 kumakatawan 
suitable or fit time	 kapanahunan, panahon
suited to the people	 karaniwan, pangkaraniwan
summary of an account showing amount owed	 kuwenta ng pagkakautang
that which gives hope of success	 may kinabukasan, may hinaharap, may pag-asa
that which is in the middle	 kalagitnaan, gitna 
that which is right, just, good, true	 katwiran, katumpakan, mabuti, matwid 
the absence of light, darkness	 dilim, kadiliman, karimlan
the absence of motion, stillness	 katahimikan 
the amount paid for any result	 bayad, kabayaran
the answer to a puzzle or problem	 sagot, kasagutan, kalutasan 
the end	 wakas, katapusan
the faculty of sensation	 (no single specific term although Balagtas in his "Florante at Laura" used "karamdaman," e.g., "limang karamdaman" - five senses. Not used now in this way). 
the greatest number of, almost all	 ang karamihan
the greatest quantity, degree or amount of, rendered in most cases by the prefix "pinaka" with the adjective or adverb, e.g. The most beautiful	 Ang pinakamaganda. Also by "kaan", "kahan" plus reduplication of the root of the adjectives, e.g. Most beautiful	 Kaganda-gandahan 
the highest point or part	 tuktok, taluktok, ituktok, kaitaasan 
the human race	 sangkatauhan 
the known facts about what a person, animal, ship, etc., has done	 rekord, kasaysayan 
the main part of a plant above the ground which supports the other parts	 katawan 
the means by which anything is done	 paraan, kasangkapan 
the middle	 gitna, kalagitnaan, sentro 
the occasion or need to employ, necessity	 kailangan, pangangailangan, paggagamitan 
the one liked best	 pinakapaborito/a, pinakamahal, pinakatangi, itinatangi sa lahat
the opposite or contrary	 kabaligtaran, kabalikan, kasaliwaan, katumbalikan 
the other day, night, etc., recently	 kamakailan lamang 
the other world, the life to come	 kabilang-buhay, huling-buhay 
the point or part that is the same distance from each end or side, center	 gitna, kalagitnaan 
the power of the mind to decide and do	 loob, kalooban, kalooban 
the right-hand side	 kanan adv. 1. in a way that is good, just, or lawful	 tama, wasto, tumpak 
the size	 midyum, katamtaman
the things of this life and the people devoted to them	 kamunduhan 
the things one has to do in a certain position	 katungkulan, trabaho, gawain 
the total of two or more numbers or things taken together, the whole	 suma, kabuuan, total 
the world, all things except those made by man	 kalikasan 
thing wanted or lacking, that for which a want is felt	 kailangan, pangangailangan 
to affect with a lessening or loss of the power of motion or feeling	 malumpo, makalumpo, lumpuhin, maparalisa, pumaralisa, paralisahin, mamatay ang kabiyak (isang bahagi) ng katawan 
to afflict with mental suffering	 magpasakit, pasakitan, magpasama ng loob, pasamain ang loob, sumugat ng kalooban (damdamin), sugatan ang kalooban 
to ask for as a right	 hingin bilang karapatan, hingin ayon sa matwid 
to be in favor of, to back up, to second	 kumatig, katigan, magtaguyod, itaguyod 
to be in want of, ought to have, be unable to do without	 mangailangan, kailanganin 
to be needed	 maging kailangan, kailanganin
to be obliged to, be forced to	 kailangan, kinakailangan 
to become spotted, have spots	 magkamantsa, mantsahan, magkabatik, mabatikan 
to bewitch as by a charm	 manggayuma, gumayuma, makagayuma, gayumahin, mambighani, bumighani, makabighani, bighaniin 
to break the law of God	 magkasala, gumawa ng pagkakasala (kasalanan) 
to bring to an end	 magtapos, tapusin, magwakas, wakasan 
to bring to an end, to conclude, to terminate	 magtapos, tumapos, tapusin, matapos, magwakas, wakasan 
to call for, require, need	 mangailangan, kailanganin 
to come to an end, die	 mamatay, yumao, sumakabilang-buhay 
to distort the meaning of	 bumaluktot, baluktutin, bumaligtad, baligtarin, mag-uwi (iuwi) sa ibang bagay, mag-iba ng kahulugan, ibahin ang kahulugan 
to dread	 kabahan after adv. following the course of, later than	 pagkatapos, pagkaraan, makalipas
to earn, gain	 kumita, pagkakitaan, kitain, 
to feel or show sympathy	 maawa, kaawaan, mahabag, kahabagan, makiramay, dumamay, damayan, makidalamhati 
to find the sum of, add	 magbuo, buuin, pagsama-samahin, kunin ang kabuuan, magsama, sumahin 
to finish	 tumapos, tapusin, magwakas, wakasan 
to forget	 makalimutan 
to furnish with shoes, e.g., a horse	 magbakal, bakalan 
to gather up courage	 magpalakas ng loob, lakasan (laksan) ang loob, tibayan ang loob
to get the measurements of	 kunin ang sukat, sukatan 
to get through or by	 lumampas, makalampas, lampasan, makaraan, dumaan, daanan 
to get, to obtain	 kumuha, makuha, kunin, magkamit, makamit, makamtan 
to get, to secure, to obtain, to win	 kumuha, makuha, kunin, magtamo, matamo, tamuhin, magkamit, makamit, kamtan 
to give a person a piece of ones mind, to scold him	 murahin, pagsabihan, kagalitan
to give a person the right or power to do something	 magbigay (bigyan) ng karapatan (kapangyarihan) 
to give more than is fair to, to take the side of someone	 kumampi, kampihan, kumiling, kilingan, pumanig, panigan 
to give pleasure	 magbigay-lugod, bigyang-lugod, magbigay-kasiyahan, bigyangkasiyahan, pasayahin, aliwin 
to give satisfaction, to satisfy	 magbigay-kasiyahan, bigyang-kasiyahan
to give what is asked	 magkaloob, ipagkaloob, pagkalooban, magbigay, ibigay, bigyan 
to have to do with, concern	 may kaugnayan, may kinalaman, matungod 
to improve the flavor of	 magtimpla, timplahan, magrikado, rikaduhan 
to let go, to let loose	 magpakawala, pakawalan 
to like very much	 magkagusto; gustuhin, ibigin, katuwaan 
to make a profit in business	 magtubo, tumubo, pagtubuan, tubuin, makinabang, pakinabangan, pakinabangin, kumita, pagkakitaan, kitain 
to make sense, to be understandable, to be reasonable	 maunawaan, makatwiran 
to mark mistakes in	 magkorek, korekin, magmarka, markahan 
to need	 mangailangan, kailanganin
to omit, to fail	 kalimutan 
to overlook	 kaligtaan, kalingatan,
to pass away, come to an end, die	 mamatay, yumao, sumakabilang-buhay, bawian ng buhay 
to please, to attract	 umakit, akitin, maakit, makaakit, magbigaykasiyahan, bigyang-kasiyahan
to put in or put on whatever is to be carried	 maglulan, lulanan, ilulan, magkarga, kargahan, ikarga
to scold, reprimand	 kagalitan, pagsabihan
to signify, denote	 mangahulugan, ipakahulugan
to size up, to form an opinion of	 magpalagay, ipalagay, tantiyahin ang kakayahan (laki, dami)
to stick to	 dumikit, manikit, dikitan, kumapit, kapitan 
to table a bill or motion, to put off discussing it	 ipagpaliban ang pag-uusap sa panukalang-batas o mungkahi 
to take after, to be like, to resemble	 magkawangis, makawangis, mawangis, magkatulad, makatulad, tumulad, matulad, magkamukha, makamukha or use adjectives	 kamukha, kawangis, katulad 
to take down means (a) to write down	 isulat, itala (b) to put down	 magbaba, ibaba (c) to lower the pride of	 magpababa ng pagkatao (karangalan), pababain ang pagkatao (karangalan) 
to take ones part in a dispute or contest, to take sides with one	 pumanig, panigan, kumampi, kampihan 
to take pains means (a) be (very) careful	 mag-ingat, pag-ingatan, magpakaingat, ingatan; (b) to make an effort	 magsikap, pagsikapan
to take trouble, to bother	 mag-abala, magpakaabala, pagkaabalahan 
to take wrongly	 pagkamalan, mapagkamalan, ipagkamali 
to tell the truth	 magtapat, ipagtapat, pagtapatan, sabihin ang katotohanan 
to the right hand	 pakanan
to turn the tables, to reverse conditions	 saliwain ang mga pangyayari (kalagayan)
to untie	 kalagan 
unbroken length	 haba, kahabaan 
under ones protection	 sa pagkakandili ni (ng) 
under way means (a) going on, in progress	 kasalukuyang ginagawa, isinasagawa, ginagawa (b) in motion	 lumalakad, tumatakbo, umaandar 
uneasiness, worry	 balisa, pagkabalisa, kabalisahan, bagabag, pagkabagabag, di-pagkapalagay
unfolded, spread out	 buka, bukad, bukadkad (for flowers); buka (for legs, wounds, etc.); nakanganga (also for wounds or mouth) 
unlimited room or place extending in all directions	 kalawakan 
untrustworthy	 hindi mapagkakatiwalaan 
useless	 walang saysay, walang kuwenta, walang kabuluhan
utensils or dishes made from silver	 kubyertos na pilak, mga kagamitang yari sa pilak
value of a thing lost, person or thing lost	 kawalan 
very brave	 napakatapang
very holy	 napakabanal, lubhang banal
violence, strength used against a person or thing	 dahas, karahasan 
want, lack of a useful or desired thing	 kawalan, kakulangan 
ways and means	 mga para-paraan, mga kaparaanan 
well off means (a) in good condition	 nasa mabuting kalagayan (b) fairly rich	 may kaya sa buhay, nakaririwasa, mariwasa, mayaman
well, healthy (old use)	 mabuti, malakas ang katawan
whole, entire	 buo, kabuuan, kalahatan, total 
wicked	 makasalanan
wise conduct, wise words	 kaalaman, karunungan, katalinuhan
wrong	 kasamaan, kamalian
wrongdoing of any kind, immoral act	 kasalanan, sala
