Anh khỏe không?	How are you?
Em khỏe.
Vì sao anh học tiếng Việt?	Why do you study Vietnamese?
Anh đã học được những gì?	What have you learned?
Anh có thích đi du lịch không?	Do you like to travel?
có	yes
không	no
Anh có thích đọc sách không?	Do you like to read books?
Anh có thích ..... không?	Do you like ...?
đọc tin tức	read news
đọc báo	read news
nhảy	dance
đi mua sắm	going shopping
nấu ăn	cook
Anh có thường .... không?	Do you usually ...?
chơi thể thao	play sports
nói chuyện	talk to
bạn bè	friends
nói chuyện với	talk to
Anh có thường nói chuyện với bạn bè không?	Do you usually talk to friends?
lái xe hơi	drive car
Thuy, 4:28 PM
Anh có ... không?
ba mẹ	parents
anh có mẹ
anh không có ba
anh có laptop
điện thoại	phone
không có gì	you're welcome
