hôm nay anh khỏe không?	how are you today?
anh khỏe	I'm good
rất vui được gặp lại anh	nice to see you again
rất vui được gặp lại anh	(rutt vooeey duu-uck gyap liee ann)
hôm nay mình ôn bài	today we review lessons
em đã gặp họ khi nào?	when did you meet them? (em daa-a gyop ha-ah key nay-ow)
em đã nói chuyện với họ khi nào?	when did you talk to them?
em đã đi Việt Nam khi nào?	when did you go to Vietnam?
em đã xem tv lúc mấy giờ vậy?	what time did you watch tv? 
em đã ôn bài lúc mấy giờ vậy?	what time did you review the lesson? 
em có biết?	do you know?
Thuy, 5:08 PM
lái xe hơi	drive a car
chạy xe hơi	drive a car
Em (có) khỏe không?	Are you good?
buồn ngủ
nghe nhạc
món ăn, thức ăn	food
đồ ăn	food
món Việt	Vietnamese food
món Thái	Thai food
đồ ăn Mỹ	American food
món ăn Mỹ	American food
mì
cám ơn, cảm ơn
cảm ơn em (vì) đã ...
với with
nói cho anh biết điều đó	tell me that
nhảy	dance
nói chuyện với anh	talk with me
Thuy, 5:34 PM
khi nào, lúc nào	when?
rời khỏi	leave
thức dậy	get up
ăn sáng	have breakfast
ăn bữa sáng	have breakfast
xin lỗi (vì) đã ...	sorry for doing..
đến trễ
nói dối
xả rác	littering
5:49 PM
lying to you
Thuy, 5:50 PM
nói dối	lying to you
nhanh	fast
quá nhanh	so fast, too fast
chạy xe, lái xe	to drive
Thuy, 5:55 PM
đến trễ, tới trễ	being late, coming late
xả rác	littering
xếp hàng	get in line
làm ồn	being noisy, making noise
